170,171,186,187,186,187,186,187,186,187,186,187,186,187,186,187,186,187,186,187,186,187,186,187,186,187,186,187,186,187,186,187,186,186,187,186,186,186,186,187,186,187,186,186,186,187,186,186,186,186,187,186,186,186,186,187,186,186,186,186,187,186,186,186,186,186,186,187,186,186,186,186,187,186,186,187,186,187,170,171
180,181,237,237,237,237,237,237,237,237,237,237,237,237,237,237,237,237,237,237,237,237,237,237,237,237,237,237,237,237,237,237,237,237,237,237,237,237,237,237,237,237,237,237,237,237,237,237,237,237,237,237,237,237,237,237,237,237,237,237,237,237,237,236,237,236,237,236,237,236,237,236,237,236,237,236,237,237,180,181
170,171,237,236,237,236,237,236,234,235,237,236,237,236,237,236,237,236,237,236,237,236,237,236,237,236,237,236,237,236,237,236,237,236,237,236,237,236,237,236,237,236,237,236,237,236,237,236,237,236,237,236,237,236,237,236,237,236,237,236,237,236,237,246,247,246,217,246,247,246,247,246,247,246,247,246,247,237,170,171
180,181,237,246,247,246,247,246,244,245,247,246,247,217,247,246,247,246,247,246,247,246,247,217,247,246,247,246,247,246,247,246,247,217,247,246,247,246,247,246,247,217,247,246,247,246,247,246,247,246,217,246,247,246,247,246,247,246,247,246,247,246,247,236,237,236,227,236,237,236,237,236,237,236,237,236,237,237,180,181
170,171,237,236,237,236,237,236,254,255,237,236,237,227,237,236,237,236,237,236,237,236,237,227,237,236,237,236,237,236,237,236,237,227,237,236,237,236,237,236,237,227,237,236,237,236,237,236,237,236,227,236,237,236,237,236,237,236,237,236,237,236,237,246,247,246,247,246,247,246,247,246,247,246,247,246,247,248,170,171
180,181,237,246,247,246,247,246,264,265,247,246,247,246,247,246,247,246,247,246,247,246,247,246,247,246,247,246,247,246,247,246,247,246,247,246,247,246,247,246,247,246,247,246,247,246,247,246,247,246,247,246,247,246,247,246,247,246,247,246,247,246,247,140,140,140,140,140,140,140,237,236,237,236,237,236,257,258,180,181
170,171,237,236,237,236,140,140,140,140,140,140,140,140,140,140,140,140,140,140,140,140,140,140,140,140,140,140,140,140,140,140,140,140,140,140,140,18,140,140,140,140,140,140,140,140,140,140,140,140,140,140,140,140,147,237,237,236,237,236,237,140,140,140,140,140,140,140,140,140,140,246,247,246,247,246,267,268,170,171
180,181,237,246,247,246,247,237,237,237,237,237,237,237,237,237,237,237,237,237,237,237,237,237,237,237,237,18,237,237,18,18,237,237,237,18,237,237,237,237,237,237,237,237,237,237,237,237,237,237,237,237,237,140,140,147,237,246,247,246,247,236,237,236,237,236,237,237,236,237,236,237,236,237,236,237,140,140,180,181
170,171,140,236,237,236,237,236,237,236,237,236,237,236,237,236,55,55,237,18,237,236,237,18,18,236,237,236,237,236,237,236,237,236,237,236,237,236,237,236,237,236,237,236,237,236,237,236,237,236,237,236,237,236,237,140,147,237,237,237,237,246,247,246,247,246,247,237,246,247,246,247,246,247,246,247,140,140,170,171
180,181,140,140,247,246,247,246,247,246,247,246,247,246,247,246,247,18,18,246,247,246,247,246,247,246,247,246,247,246,247,246,247,246,247,246,247,246,247,246,247,246,247,246,247,246,247,246,247,246,247,246,247,246,247,237,140,147,237,66,66,236,237,236,237,278,279,237,236,237,236,237,236,237,140,140,140,140,180,181
170,171,140,140,237,237,237,237,237,236,237,236,237,236,237,236,237,18,55,236,237,236,237,236,237,236,237,236,237,236,237,236,237,236,237,236,237,236,217,236,237,236,237,230,231,232,233,236,237,64,64,64,64,236,237,237,237,66,66,246,247,246,247,246,247,288,289,237,246,247,246,247,246,247,140,140,140,140,170,171
180,181,140,140,140,140,140,140,140,140,247,246,18,246,247,246,247,246,55,246,247,246,247,246,247,246,247,246,247,246,247,246,190,246,247,246,247,246,227,246,247,246,247,240,241,242,243,246,64,64,64,64,214,214,64,214,214,214,64,214,64,64,237,237,237,237,237,237,237,237,237,237,140,140,140,140,140,140,180,181
170,171,237,236,237,236,237,236,237,140,64,64,18,236,237,140,140,236,237,55,237,236,237,236,237,236,237,236,237,236,237,236,237,236,214,236,214,214,214,214,214,236,237,214,251,64,214,214,214,214,237,236,237,236,237,236,237,246,247,246,190,246,64,64,142,140,140,237,246,247,237,140,140,140,140,140,140,140,170,171
180,181,237,246,217,246,247,246,247,246,247,246,18,18,247,246,140,246,247,55,247,246,247,246,247,246,247,246,66,246,247,214,247,246,247,246,247,246,247,246,247,246,247,260,64,262,263,64,247,64,64,64,64,64,64,246,247,236,237,236,237,237,237,142,140,237,236,237,236,237,236,237,236,237,236,237,236,237,180,181
170,171,237,236,227,66,66,236,237,236,237,236,237,236,64,64,140,140,140,55,140,140,140,140,140,140,237,237,66,214,214,237,237,237,237,237,237,140,140,140,140,64,64,140,140,140,140,64,140,140,140,66,237,237,237,64,64,246,247,246,247,237,142,140,237,237,246,247,246,247,246,247,246,247,246,247,246,247,170,171
180,181,237,246,247,246,66,246,247,246,247,246,247,246,257,64,64,236,237,236,237,236,237,236,237,236,217,236,66,236,140,140,237,236,237,236,237,236,237,64,237,236,237,236,237,236,64,236,237,236,237,236,66,236,237,217,64,64,237,237,237,142,140,237,236,237,236,237,236,237,236,237,236,237,236,237,236,237,180,181
170,171,237,237,237,237,66,66,237,237,237,237,237,237,267,268,140,64,247,246,247,66,66,235,247,246,227,246,66,246,140,140,247,246,247,246,247,246,64,246,247,246,247,246,247,246,64,66,247,246,247,190,247,66,247,227,247,246,64,237,142,140,237,237,246,247,246,247,246,247,246,247,246,247,246,247,246,247,170,171
180,181,237,236,247,236,247,66,237,246,247,140,140,140,140,140,140,236,64,64,237,66,244,245,237,236,237,236,66,248,66,140,66,236,237,236,237,236,237,236,237,236,237,236,236,236,237,66,237,236,237,66,237,66,66,236,237,237,237,64,140,237,236,237,236,237,236,237,236,237,236,237,236,237,236,237,236,237,180,181
170,171,237,237,237,237,237,66,237,237,246,246,246,237,246,237,237,246,247,246,66,246,254,255,247,246,247,246,66,258,140,140,140,66,247,246,247,246,247,246,247,246,247,236,237,246,66,246,247,246,247,66,247,246,66,246,247,237,142,140,64,64,246,247,237,237,237,237,237,237,237,247,246,247,246,247,246,247,170,171
180,181,236,237,236,237,236,237,66,237,236,237,236,237,236,246,246,246,246,66,64,64,264,265,237,237,237,237,66,268,140,140,140,140,66,66,237,237,237,236,237,236,237,246,247,236,66,236,237,236,237,66,237,237,237,237,237,142,140,237,237,237,64,237,237,237,64,237,237,237,237,237,237,64,236,237,236,237,180,181
170,171,246,247,246,247,246,247,66,247,246,247,246,247,246,247,246,247,66,247,246,247,64,187,186,187,186,187,66,187,186,187,186,187,186,149,66,66,237,246,247,246,247,246,247,66,66,246,247,246,247,66,149,149,186,187,186,187,186,187,186,187,64,187,186,187,64,187,186,187,186,187,186,64,246,247,246,247,170,171
180,181,236,237,236,237,236,237,237,66,236,237,88,237,236,237,66,66,66,89,89,66,66,64,66,66,237,66,66,66,64,66,237,66,66,236,237,66,66,66,237,236,237,237,237,237,237,237,66,66,66,66,66,66,66,66,237,236,237,236,237,236,237,64,237,236,237,237,236,237,236,237,236,64,236,237,236,237,180,181
170,171,246,247,246,247,246,247,140,66,66,247,88,247,246,247,246,66,140,140,89,140,140,246,64,246,247,246,64,66,66,66,66,66,66,212,66,66,66,66,66,66,66,149,148,149,237,246,247,246,66,246,247,246,247,246,247,246,247,246,247,246,247,246,64,246,64,237,246,247,246,247,64,64,246,247,246,247,170,171
180,181,236,237,217,237,236,237,140,140,66,66,88,237,236,237,236,66,237,236,237,236,237,236,237,64,64,64,237,236,237,236,237,236,237,236,237,236,237,236,237,237,148,237,236,237,149,236,237,236,66,236,237,236,237,236,237,236,237,236,237,236,237,236,237,236,64,237,236,237,236,64,64,237,217,237,236,237,180,181
170,171,246,247,227,247,246,247,140,237,246,66,88,247,246,247,246,247,237,246,247,64,64,64,64,246,64,212,212,212,246,246,247,217,247,246,247,246,247,246,247,237,237,237,246,247,237,246,247,246,66,246,89,89,89,89,247,246,247,246,247,246,247,246,247,246,247,64,246,247,246,64,245,247,227,247,247,248,170,171
180,181,236,237,236,64,236,237,140,236,237,236,88,140,237,236,64,64,64,64,64,236,237,236,237,236,237,212,64,246,246,64,237,227,237,64,237,237,237,237,237,237,237,236,237,236,237,236,237,66,237,237,237,236,237,227,89,89,237,236,237,140,140,140,140,140,140,237,236,237,236,254,255,237,236,237,257,258,180,181
170,171,246,247,246,247,246,247,140,246,247,246,88,140,237,246,247,246,247,246,247,246,247,246,89,217,247,246,64,64,64,246,247,246,247,246,247,142,149,237,237,246,247,246,247,246,247,246,247,66,148,147,237,246,247,246,247,64,89,89,247,236,237,237,236,237,236,237,246,247,246,264,265,247,246,247,267,268,170,171
180,181,236,237,236,237,236,237,140,236,237,236,88,140,140,66,66,237,237,236,237,236,237,236,64,64,89,246,246,236,190,237,237,237,237,237,142,149,237,246,246,246,64,64,64,64,64,236,64,64,64,64,147,190,64,64,64,237,237,236,89,89,247,237,246,247,246,247,236,237,140,140,140,140,140,140,140,140,180,181
170,171,246,247,246,247,246,247,140,246,247,246,88,140,140,66,246,247,237,246,247,246,247,246,247,246,246,246,247,246,247,142,149,148,246,246,246,246,246,246,237,246,247,246,247,246,247,246,247,236,237,237,148,149,148,149,148,147,237,246,247,89,89,237,236,217,236,237,246,247,236,237,236,237,236,237,236,237,170,171
180,181,143,237,236,237,237,144,143,236,237,236,88,143,144,66,187,186,187,186,246,246,246,246,236,246,246,246,246,246,246,246,246,246,237,237,237,237,246,247,89,66,237,148,64,64,64,64,64,237,247,237,237,237,237,237,237,148,147,236,237,246,247,89,246,227,246,247,237,237,246,247,246,247,246,247,246,247,180,181
170,171,237,237,246,247,237,237,237,246,247,246,88,237,237,237,237,237,237,237,237,237,246,247,246,247,246,247,148,149,237,236,237,89,89,236,89,89,89,89,237,236,142,148,149,147,237,236,237,236,237,236,237,236,237,236,237,236,148,147,247,236,237,89,89,237,236,237,236,237,236,237,236,237,236,237,236,237,170,171
180,181,236,237,236,237,236,237,236,237,204,205,236,237,236,237,236,237,236,237,236,237,66,66,66,66,66,66,237,66,237,246,66,246,66,246,247,246,247,246,247,142,148,246,247,149,147,246,247,246,247,246,247,246,247,246,247,246,247,148,147,246,247,237,246,89,246,247,246,247,246,247,246,247,204,205,246,247,180,181
170,171,246,247,246,247,246,247,246,247,214,215,246,247,246,247,246,247,246,247,246,247,246,247,246,247,237,237,236,237,236,237,236,237,236,237,236,237,237,237,142,148,237,236,237,236,149,147,237,246,247,236,237,236,237,236,237,236,237,236,148,147,237,237,236,237,89,237,237,237,236,237,236,237,214,215,236,237,170,171
180,181,236,237,236,237,236,237,236,237,224,225,236,237,236,237,236,237,236,237,236,237,237,237,237,142,149,237,246,247,246,247,246,247,148,247,246,247,148,149,148,246,247,204,205,246,247,149,148,89,148,89,247,89,247,246,89,246,247,246,247,148,147,237,246,247,237,89,147,237,246,247,246,247,224,225,246,247,180,181
170,171,246,247,246,247,246,247,246,247,246,247,246,247,234,235,246,247,246,247,246,247,237,142,149,148,149,237,236,237,236,237,246,149,148,246,246,246,236,237,237,237,236,214,215,237,236,237,236,237,236,247,237,149,148,236,237,236,237,89,237,237,89,147,236,237,237,247,140,147,237,237,236,237,236,237,236,237,170,171
180,181,236,237,236,237,236,237,236,237,236,237,236,237,244,245,236,237,237,237,237,142,149,148,149,148,149,237,246,247,246,246,246,246,246,247,246,247,246,247,246,247,246,224,225,247,246,247,237,237,237,237,237,246,246,246,247,246,247,246,247,237,237,148,147,247,89,247,140,89,89,89,246,247,246,247,247,248,180,181
170,171,246,247,246,247,246,247,246,247,246,247,246,247,254,255,246,247,237,142,149,148,149,148,149,148,149,237,236,148,148,246,246,246,246,237,236,237,236,237,236,237,236,237,236,237,236,237,236,237,236,237,236,246,246,246,246,148,148,236,237,236,237,237,148,148,148,149,140,140,140,147,237,236,237,236,257,258,170,171
180,181,237,237,237,237,237,237,237,237,237,237,237,237,264,265,237,237,142,149,148,149,148,148,149,148,149,237,246,148,148,246,246,246,246,247,246,247,246,247,246,247,246,247,246,247,246,247,246,247,246,247,246,246,246,246,246,148,148,246,247,246,247,237,148,148,148,148,140,140,140,140,147,246,247,246,267,268,180,181
170,171,140,140,140,140,140,140,140,140,140,140,140,140,140,140,140,140,140,140,140,140,140,140,140,140,140,140,140,140,140,140,140,140,140,140,140,140,140,140,140,140,140,140,140,140,140,140,140,140,140,140,140,140,140,140,140,140,140,140,140,140,140,140,140,140,140,140,140,140,140,140,140,140,140,140,140,140,170,171
180,181,141,141,141,141,141,141,141,141,141,141,141,141,141,141,141,141,141,141,141,141,141,141,141,141,141,141,141,141,141,141,141,141,141,141,141,141,141,141,141,141,141,141,141,141,141,141,141,141,141,141,141,141,141,141,141,141,141,141,141,141,141,141,141,141,141,141,141,141,141,141,141,141,141,141,141,141,180,181