170,171,186,187,62,62,62,62,57,57,62,62,62,187,186,187,186,187,186,62,186,187,186,187,186,187,186,187,186,187,186,187,99,186,187,186,186,52,52,187,186,187,186,52,186,187,52,186,99,186,187,186,186,186,186,187,186,186,52,52,187,186,186,186,52,52,186,187,186,186,186,186,187,186,186,187,186,187,170,171
180,62,62,62,62,237,237,57,57,57,62,62,62,62,62,62,62,62,237,62,237,237,237,237,237,237,237,237,237,237,237,99,99,237,237,237,237,237,52,52,99,237,52,237,237,52,99,99,99,52,237,237,237,237,237,237,237,237,237,237,52,237,237,236,52,236,52,236,237,236,237,236,237,236,237,52,237,237,180,181
62,62,62,62,62,62,57,57,62,57,62,62,62,62,62,57,57,62,62,62,62,236,237,236,237,236,237,236,237,236,237,99,237,236,237,236,237,236,237,52,99,52,52,99,52,52,99,236,237,52,237,236,237,236,237,236,237,236,237,236,237,52,52,52,247,246,52,52,247,246,247,246,247,246,247,52,247,237,170,171
62,62,62,62,62,62,57,62,62,57,57,57,57,57,57,57,62,57,62,62,62,44,247,217,247,246,44,246,247,246,247,99,99,217,99,99,247,99,99,99,52,52,247,52,247,246,247,246,247,52,217,246,247,246,247,246,247,246,247,246,247,246,247,52,237,236,227,52,237,236,237,236,237,236,237,236,52,237,180,181
62,62,62,62,62,57,62,62,62,57,57,62,62,57,62,62,62,57,62,62,62,236,237,227,237,236,44,236,237,99,99,99,237,99,237,236,237,236,237,236,52,52,52,236,237,236,237,236,237,44,44,44,44,44,44,44,44,44,44,44,44,236,52,246,247,52,52,246,52,246,247,246,247,246,247,246,247,248,170,171
62,62,62,62,57,57,62,57,57,57,62,62,57,57,62,62,62,62,57,62,62,246,247,99,247,44,44,99,247,246,99,246,247,246,247,246,247,246,247,246,52,52,247,246,55,246,55,55,55,52,247,55,247,55,55,55,55,246,55,55,44,44,44,140,140,140,140,52,52,52,237,236,237,236,237,236,52,52,180,181
62,62,62,62,57,57,57,57,62,62,62,57,57,62,62,62,62,62,57,62,156,156,156,156,44,44,140,140,140,140,99,140,140,140,140,140,140,140,140,140,52,52,55,55,44,44,44,140,140,52,52,140,140,140,147,237,237,236,237,236,55,55,55,140,140,140,140,140,52,140,52,52,247,246,247,246,267,52,170,171
62,62,62,57,62,62,62,57,57,57,57,57,62,62,62,62,62,62,57,156,156,237,237,237,156,156,237,237,237,99,99,237,237,237,237,237,237,237,55,55,55,52,44,44,237,237,237,237,237,52,52,237,237,140,140,147,237,246,247,246,247,52,44,55,237,236,237,237,52,237,236,237,236,52,236,52,140,140,52,181
62,62,62,57,62,62,62,62,62,62,62,62,57,62,62,62,62,62,57,156,99,99,237,44,237,156,237,236,237,99,237,236,237,236,156,236,237,55,237,236,237,44,44,236,237,236,237,236,237,52,237,236,237,236,237,140,147,237,237,237,52,246,44,55,55,246,247,237,52,247,246,247,246,247,246,247,140,140,170,171
62,215,215,57,62,57,62,62,62,62,62,62,57,62,62,57,57,57,57,156,62,246,99,44,247,156,247,246,156,156,156,246,247,156,156,55,55,246,247,52,44,44,99,52,247,246,247,246,247,55,52,52,247,246,247,237,140,147,237,236,55,55,55,55,237,278,279,237,52,237,236,237,236,237,140,140,140,140,52,181
62,215,215,57,62,57,62,62,62,62,62,62,57,62,57,62,62,57,57,62,237,236,44,99,99,156,237,236,99,236,237,156,237,55,237,236,237,236,52,44,44,236,237,52,231,44,44,44,44,55,44,44,44,44,44,237,237,55,55,55,247,246,247,44,247,288,289,237,52,247,246,247,246,247,140,140,140,140,170,52
180,99,99,57,56,99,57,46,46,140,247,57,57,57,247,246,57,57,57,156,247,44,247,246,247,246,99,99,247,246,247,55,55,246,247,246,65,65,65,44,56,56,247,44,44,44,44,44,55,55,44,227,247,246,247,44,55,55,237,52,237,236,237,44,237,237,237,237,52,237,237,237,140,140,140,140,140,140,180,52
99,99,237,57,56,56,57,236,46,140,140,57,57,236,237,57,57,156,156,57,156,156,237,236,237,236,237,99,237,236,237,55,156,236,237,236,237,52,44,236,52,44,44,44,44,44,44,44,55,44,44,44,44,44,44,55,237,44,52,246,247,246,247,44,142,140,140,52,246,247,237,140,140,140,140,140,140,140,170,52
180,99,99,57,217,56,57,246,247,46,57,57,57,57,55,246,140,156,156,57,156,156,156,88,247,99,99,246,44,44,156,55,44,44,247,246,247,44,52,246,247,44,44,56,44,44,263,246,55,52,44,44,52,55,55,44,44,236,44,236,237,237,237,44,140,237,236,52,236,237,236,237,236,237,236,237,236,237,180,52
99,171,237,236,57,56,237,236,237,57,57,57,237,236,55,248,156,156,57,57,156,156,156,156,156,156,156,156,156,156,55,237,237,237,44,237,237,44,140,140,44,44,55,55,55,55,55,55,44,44,44,44,55,237,237,237,44,44,247,44,247,237,142,44,237,237,52,247,246,247,246,247,246,247,246,247,246,247,170,171
180,181,237,246,57,56,247,57,247,57,57,88,247,246,55,156,156,57,57,66,66,156,156,156,156,156,44,156,156,55,140,51,237,236,21,65,44,21,237,21,65,21,237,65,237,65,55,55,237,52,65,55,44,236,237,217,52,44,44,44,237,142,140,44,44,52,236,237,236,237,236,237,236,237,236,237,236,237,180,181
99,99,99,99,99,57,99,57,99,57,57,99,99,237,99,55,57,57,66,66,99,156,234,156,156,44,156,88,247,21,51,21,247,246,247,44,44,52,44,55,44,44,21,55,21,99,247,246,55,52,55,44,44,44,44,44,44,44,44,44,44,140,237,237,44,247,246,247,246,247,246,247,246,247,246,247,246,247,99,99
99,181,237,236,247,57,57,57,66,66,57,57,57,99,57,55,55,66,66,236,55,156,55,44,21,236,55,21,55,55,55,140,55,236,55,55,44,55,55,44,55,55,237,236,99,21,21,99,55,44,55,236,44,52,52,236,237,237,44,142,44,44,44,44,44,44,236,52,236,237,236,237,236,237,236,99,99,237,99,181
99,99,99,237,237,237,56,237,57,66,57,237,237,55,55,55,88,99,44,99,247,56,21,156,247,246,106,106,99,55,99,99,44,99,99,99,44,55,99,99,99,44,44,99,66,44,66,21,52,55,99,99,44,44,99,99,55,55,55,99,99,44,52,44,44,44,237,52,99,99,237,99,99,247,99,247,246,52,52,52
180,181,99,99,99,237,56,237,57,66,236,237,55,55,236,88,66,99,44,99,21,237,156,265,106,106,65,99,55,268,99,44,140,140,237,44,55,55,44,236,52,56,44,52,44,44,237,52,21,52,55,56,44,44,55,55,55,99,44,55,237,44,237,237,44,237,44,52,52,237,237,237,237,237,236,52,52,52,180,181
170,171,99,99,99,247,99,247,246,66,66,247,55,247,88,65,66,44,246,21,99,99,44,106,65,65,65,88,55,44,65,187,186,187,186,65,149,44,44,21,21,21,21,21,21,21,247,99,66,21,65,55,55,55,44,65,186,187,44,52,55,55,44,99,186,44,44,52,52,52,186,187,186,52,52,247,99,247,170,171
180,181,236,99,99,237,236,99,99,237,66,237,55,55,236,88,55,44,237,106,106,106,65,65,99,99,99,99,21,44,21,99,21,56,21,21,21,21,21,21,56,21,21,44,21,237,237,21,55,21,55,55,44,66,66,66,66,236,44,236,237,236,55,99,99,44,44,44,99,52,52,52,52,237,99,99,99,237,180,181
170,171,246,99,99,247,246,56,140,99,66,247,246,55,55,88,21,44,106,106,106,106,44,99,21,246,21,88,55,51,51,246,247,21,21,44,52,44,21,21,247,44,44,44,44,44,44,44,55,21,66,21,44,21,44,246,66,66,66,246,247,246,55,246,247,246,44,44,246,247,99,99,99,99,99,247,246,247,170,171
180,181,236,99,99,237,236,237,56,140,66,66,66,66,66,55,21,44,106,46,99,99,21,21,56,236,237,55,55,236,21,21,237,55,55,56,21,21,44,236,237,44,44,44,236,237,149,55,55,55,44,99,44,66,21,52,21,44,237,66,237,236,55,44,237,236,44,44,44,237,236,234,235,237,217,237,236,237,180,181
170,171,246,99,99,247,246,247,56,237,246,52,66,66,246,65,55,55,55,55,21,55,55,55,55,55,55,55,51,21,247,56,55,217,55,99,21,44,52,44,247,237,44,44,246,247,55,55,55,99,66,246,66,66,247,56,21,21,21,246,66,66,55,44,247,246,247,44,44,247,246,244,245,247,227,247,247,248,170,171
180,181,236,99,99,237,236,237,140,56,237,236,237,66,66,21,44,21,21,21,65,106,44,236,56,65,88,51,21,88,65,55,237,227,55,21,66,66,52,44,237,237,44,55,55,65,55,52,55,237,65,44,99,44,66,65,44,236,21,236,237,66,140,44,140,140,140,44,44,52,236,254,255,237,236,237,257,258,180,181
170,171,246,99,99,99,99,99,99,99,99,99,99,99,99,21,21,246,99,106,106,106,44,44,56,217,51,21,44,55,247,66,66,21,21,55,55,55,66,55,55,55,55,44,247,55,44,246,55,55,148,44,66,44,66,56,247,246,21,55,55,236,66,66,44,44,44,44,44,52,52,264,265,247,246,247,267,268,170,171
180,181,236,99,99,237,236,237,140,236,56,56,237,99,99,99,66,66,106,88,106,106,106,44,44,51,21,44,237,66,66,66,237,21,56,99,44,149,66,52,44,236,44,44,55,55,52,44,44,55,55,55,55,55,55,55,55,55,21,236,237,246,247,66,44,247,246,44,44,44,52,140,140,140,140,140,140,140,180,181
170,171,246,99,99,247,246,247,140,52,247,246,99,99,140,44,88,247,66,66,106,106,106,88,44,21,21,66,66,246,65,55,21,44,56,148,44,237,66,44,44,52,44,44,55,246,52,44,44,44,44,44,66,149,148,149,66,147,21,246,247,236,237,44,66,217,236,52,44,44,44,237,236,237,236,237,236,237,170,171
180,181,143,99,99,237,237,144,143,52,237,99,99,143,56,44,187,88,55,66,66,66,66,66,66,21,66,55,44,44,44,55,21,237,237,237,52,44,246,66,44,52,44,55,44,52,44,237,44,44,44,44,99,52,237,237,66,21,147,236,237,246,247,44,66,66,246,52,44,44,44,44,246,247,246,247,246,247,180,181
170,171,237,99,99,247,237,237,237,246,247,99,247,237,237,44,56,56,55,55,65,106,106,51,55,21,246,44,56,149,237,55,21,236,237,65,52,44,237,66,65,44,55,55,44,44,237,44,44,44,44,236,66,99,52,236,56,21,66,147,247,236,237,44,44,66,236,44,44,44,52,44,236,237,236,237,236,237,170,171
180,181,236,99,99,237,236,237,236,237,99,99,236,237,236,44,44,237,236,55,55,55,55,55,88,21,236,236,44,56,237,246,21,55,55,55,52,56,44,66,56,55,55,44,44,44,44,44,44,99,247,246,99,99,247,52,21,52,66,148,147,66,247,44,44,66,246,44,52,44,52,44,246,247,204,205,246,247,180,181
170,171,246,247,99,247,246,247,246,247,99,215,246,247,246,247,44,247,246,247,135,99,51,51,51,21,51,51,51,44,44,52,21,237,66,237,66,55,66,66,55,44,44,56,44,236,44,44,99,99,247,99,66,236,99,21,56,52,237,66,66,66,237,44,236,66,237,44,52,44,44,44,236,237,214,215,236,237,170,171
180,181,236,237,99,237,236,237,236,237,99,225,236,237,236,237,44,44,236,237,135,99,99,99,99,21,99,99,99,99,44,44,21,44,44,44,44,44,44,66,44,44,44,44,44,44,247,99,148,148,99,99,247,21,99,246,56,52,247,246,66,66,66,44,246,66,44,44,52,237,44,66,246,247,224,225,246,247,180,181
170,171,246,247,99,99,246,247,246,99,99,247,246,247,234,235,246,44,44,247,99,99,99,142,149,21,56,56,236,237,236,99,21,99,148,246,52,52,52,56,66,44,66,214,66,44,44,237,236,99,99,247,21,149,148,99,237,52,237,236,237,44,66,66,66,66,237,247,52,147,52,66,236,237,236,237,236,237,170,171
180,181,236,237,99,99,236,99,236,99,236,237,236,237,244,245,236,237,237,44,44,99,99,148,56,21,149,237,246,247,246,246,21,21,21,52,99,99,51,56,66,247,246,224,225,21,56,44,52,21,21,237,237,246,246,99,247,52,247,44,44,44,237,148,66,66,66,66,66,52,52,66,246,247,246,247,247,248,180,181
170,171,246,247,99,99,246,247,246,99,246,247,246,247,254,255,246,247,237,99,106,44,44,44,56,21,149,237,52,148,52,246,52,52,21,21,21,21,99,21,21,66,21,21,21,21,66,21,99,44,66,44,66,44,44,44,44,44,44,236,237,236,237,237,66,66,148,149,140,66,66,66,66,236,237,236,257,258,170,171
180,181,237,237,99,237,99,237,237,99,237,237,237,237,264,265,237,237,142,149,106,99,106,99,44,21,21,44,44,44,148,246,99,99,99,52,99,21,21,21,21,21,21,99,99,247,246,99,246,52,52,247,246,246,56,246,99,52,52,246,247,246,247,237,66,66,66,148,140,52,66,66,66,246,247,246,267,268,180,181
170,171,140,140,99,140,99,99,99,99,140,140,140,140,140,140,140,140,140,106,106,106,99,135,99,140,21,21,21,21,21,21,21,21,21,21,44,21,44,51,51,99,99,66,66,99,99,99,66,140,66,140,56,56,140,140,99,52,52,140,140,140,140,66,140,140,140,66,66,66,66,66,66,140,140,140,140,140,170,171
180,181,141,141,99,141,141,99,141,99,99,141,141,141,141,141,141,141,141,99,106,106,99,135,141,99,99,99,56,141,141,141,141,141,141,141,99,141,141,141,51,99,141,99,66,66,141,141,99,99,99,56,141,141,141,52,99,52,141,141,141,141,66,66,141,141,141,141,141,141,141,141,66,66,141,141,141,141,180,181
21,21,21,21,21,21,21,21
21,21,21
21,21
21
21,21,21,21,21
21,21
21,21,21,21,21,21,21,21
21,21,21
21,21,21,21,21
21,21,21
21,21,21,21,21
21,21,21,21
21,21
21,21
66,66,66,66
21,21
21,21,66,66
21
66,66,66,66,66,66
21,21
66,66,66,66,66,66,66,66
21,21
21,21,66,66,66
21,21
66
21
66,66
21,21,66,66
21,21
66,66
21
66,66,66
21
21,21,66,66,66,66
21
66,66,66,66,66,66,66
21
66,66,66,66,66,66,66,66
21
66,21,66,66,66,66,66
21
66,66,66,66,66,66,66
21
66,66,66,66,66
21
66,66,66,66
21
66,66,66,66,66,66
21
66,66,66,66,66,66
21,21,21,21,21,21,21,21
66,66,66,66,66,66,66,66
21,21,21,21,21
66,66,66
21,21,21
66,66
21,21,21,66
21,21,21,21
21,21,21
21,21,21,21,21
21,21,21,21,21,21,21,21
21,21,21
21
21