170,171,186,187,186,99,99,99,186,187,46,66,46,46,46,46,46,66,66,66,46,66,66,66,66,66,66,66,66,66,66,66,66,66,66,66,66,66,66,66,66,187,66,66,66,66,66,66,66,99,99,99,99,99,99,99,66,186,66,66,66,66,66,66,66,66,66,66,66,66,66,66,66,186,186,187,186,187,170,171
5,4,4,180,99,99,4,4,237,237,66,66,66,66,66,237,237,237,237,237,237,237,99,237,237,237,237,237,66,66,66,66,66,237,237,237,237,237,237,237,237,237,237,237,237,237,237,99,99,237,237,237,237,237,237,46,99,99,99,237,237,237,237,237,237,237,236,237,236,237,236,237,66,237,236,237,236,237,236,237,237,180,181
5,5,4,99,171,46,4,66,66,66,66,66,235,237,236,237,236,237,236,237,236,237,236,237,236,237,99,237,236,237,236,237,66,66,66,66,66,66,66,66,66,66,66,66,66,99,99,66,66,66,66,66,66,66,236,66,66,66,66,99,99,66,236,237,236,237,246,247,246,217,246,66,246,247,246,247,246,247,246,247,237,170,171
5,4,180,99,46,46,66,66,247,246,244,245,66,246,247,217,247,246,247,246,247,246,247,246,247,217,247,246,247,246,247,246,247,246,247,217,247,246,247,246,247,246,247,99,247,246,247,246,247,246,247,246,217,246,247,246,247,246,247,246,247,66,99,246,247,236,237,236,227,236,237,66,237,236,237,236,237,236,237,237,180,181
5,5,46,99,170,66,66,22,22,236,237,236,66,255,237,236,237,227,237,236,237,236,237,236,237,236,237,227,237,236,99,236,237,236,237,236,237,227,237,236,237,236,99,46,46,46,46,46,46,46,237,236,237,236,227,236,237,236,237,236,237,236,66,99,237,236,237,246,247,246,66,66,247,246,247,246,247,246,247,246,247,248,170,171
5,46,46,99,66,66,246,247,246,247,246,264,66,247,19,19,19,19,19,247,246,247,246,247,246,247,246,247,246,247,246,247,246,99,246,247,246,247,46,99,46,99,46,247,246,247,246,247,246,247,46,247,246,247,246,247,246,247,246,247,246,247,66,247,66,99,66,66,66,66,66,140,140,237,236,237,236,237,236,257,258,180,181
5,46,22,99,99,237,236,237,236,140,140,140,140,19,140,140,140,140,140,19,19,19,19,19,19,56,56,56,56,56,56,56,56,56,56,56,99,46,99,56,56,56,56,56,56,56,56,56,56,56,46,56,56,56,56,56,56,147,237,237,236,237,66,237,140,140,140,66,66,66,66,140,140,140,246,247,246,247,246,267,268,170,171
22,46,66,66,246,99,99,99,237,237,237,237,66,19,237,237,237,237,56,56,237,237,237,237,237,19,19,19,19,237,237,18,46,99,46,99,18,237,99,237,237,237,237,237,46,46,46,46,46,46,46,46,46,46,46,46,46,46,46,46,46,46,46,46,46,237,236,237,237,99,66,66,237,236,237,236,237,140,140,180,181
22,46,46,170,171,140,236,99,46,99,236,237,236,19,236,237,236,237,56,55,99,99,18,99,236,237,99,99,99,237,99,99,99,237,99,237,236,99,236,237,99,99,236,99,46,237,99,46,236,99,236,46,99,237,56,99,236,99,99,46,99,99,99,99,246,247,246,247,246,66,66,246,247,246,247,246,247,246,247,140,140,170,171
66,66,46,140,247,246,247,246,46,246,99,99,99,99,99,246,99,99,56,99,247,99,99,246,99,99,247,246,19,246,46,246,247,246,247,246,247,246,247,246,99,99,66,99,66,46,247,246,247,246,247,46,247,46,247,237,46,46,46,66,46,46,46,46,99,99,46,46,46,66,46,99,46,46,46,140,140,140,180,181
66,171,46,140,237,237,237,46,237,236,237,236,66,19,237,236,237,56,55,236,237,236,237,99,237,236,237,236,46,46,237,236,237,236,237,236,99,66,99,236,237,19,237,19,46,99,99,66,237,19,19,46,19,46,46,46,237,66,66,46,46,246,247,66,247,99,289,237,66,247,246,247,246,247,140,46,46,140,170,171
66,181,46,140,140,140,140,46,140,140,247,246,66,66,247,246,247,56,55,246,247,246,247,246,99,246,247,46,46,246,247,246,66,66,99,99,66,66,66,66,66,66,66,240,241,46,99,99,66,99,64,99,46,99,99,19,99,214,99,99,64,99,237,66,237,99,237,46,66,46,46,237,140,99,140,140,46,140,99,181
66,171,46,236,237,236,46,236,237,140,64,64,18,66,237,140,140,19,19,19,19,19,19,19,19,99,237,46,237,66,66,66,66,99,214,236,214,214,19,19,214,236,19,66,66,66,99,99,214,99,99,46,46,236,46,236,19,246,247,46,190,246,64,99,142,99,99,66,246,247,237,46,140,140,140,99,140,46,99,171
66,181,237,46,217,46,46,246,247,246,247,246,18,66,247,19,19,56,247,55,247,246,247,246,247,46,99,19,66,66,66,66,99,99,247,246,247,19,19,19,247,19,247,260,99,99,66,66,66,66,66,99,99,19,46,246,247,236,19,46,237,237,237,66,140,99,66,99,99,237,236,46,236,237,236,237,236,99,99,46
66,171,237,46,227,46,66,236,9,236,237,236,237,66,66,64,140,56,140,55,140,140,140,140,140,46,19,99,66,66,214,237,99,237,237,237,237,19,140,140,140,99,99,140,99,46,140,46,46,140,66,66,66,99,99,64,64,246,247,46,19,237,142,66,237,99,66,247,99,99,246,247,46,247,246,247,246,99,99,46
66,66,237,46,247,46,66,246,9,246,247,246,247,246,66,19,64,56,237,236,237,236,237,236,237,46,66,66,99,19,19,140,99,236,237,236,237,19,237,99,237,236,237,99,237,46,64,46,237,66,237,236,46,236,66,99,64,64,237,46,237,19,140,66,46,99,236,237,236,99,236,237,236,46,236,237,236,46,180,46
170,66,237,237,46,46,66,66,9,62,237,237,237,19,9,66,140,56,247,246,247,66,66,235,46,66,66,246,99,246,140,19,99,246,247,66,66,99,99,66,66,66,99,66,247,66,66,66,66,66,247,66,66,66,46,66,99,246,64,46,142,140,19,66,66,247,246,247,246,247,246,247,246,46,46,247,246,99,170,46
180,66,237,236,247,46,247,66,237,62,247,140,140,9,9,140,66,66,66,64,237,66,244,66,66,236,66,236,66,99,66,19,99,66,66,99,99,19,19,236,237,99,66,236,66,46,46,46,46,236,46,46,237,66,46,66,99,66,237,64,46,237,66,19,66,99,236,237,236,237,99,237,236,237,46,237,236,46,180,46
170,66,237,237,46,46,9,66,66,62,246,246,9,9,246,237,19,19,247,66,66,66,66,66,19,66,66,246,66,99,140,140,99,66,99,246,66,246,19,99,247,246,247,236,237,246,46,46,46,46,46,66,247,246,46,99,19,66,66,140,46,66,46,66,19,99,237,237,237,237,237,247,246,247,46,247,99,46,46,171
180,66,236,237,236,46,9,19,66,62,236,237,9,19,66,66,56,19,66,62,64,66,66,265,237,66,237,237,66,268,99,19,99,140,99,66,237,99,19,19,237,236,46,46,46,46,66,236,46,236,46,46,99,99,237,66,19,66,66,66,46,46,46,66,237,19,64,237,237,237,237,99,237,64,46,237,236,46,46,181
170,66,246,247,246,9,56,19,66,62,99,9,9,19,246,66,56,247,19,247,46,66,46,66,46,66,46,66,66,62,46,99,99,99,99,99,46,66,46,46,46,46,247,66,247,66,66,66,46,46,99,99,66,66,66,46,46,46,46,66,46,46,66,187,186,99,64,187,186,187,186,99,186,64,46,247,99,46,46,171
180,181,66,237,236,9,46,19,66,99,99,99,66,19,236,66,56,66,19,46,66,66,66,64,66,66,237,99,66,99,66,99,66,99,99,236,237,66,66,66,19,236,237,66,66,99,237,99,99,66,66,66,66,46,66,66,19,236,66,66,237,46,237,64,237,99,237,237,236,237,236,99,236,64,46,237,236,46,46,181
170,171,66,247,9,247,46,66,66,99,66,66,99,99,99,247,99,99,46,99,62,140,99,246,99,246,99,246,64,19,66,99,66,62,99,99,99,99,99,99,66,99,99,66,99,149,66,66,66,66,66,246,46,46,46,246,19,66,66,246,247,46,66,246,99,19,64,237,246,99,99,247,64,64,246,46,99,46,46,171
180,181,66,237,9,237,46,46,66,66,9,66,62,19,236,56,236,46,46,66,62,62,237,236,66,64,64,64,19,236,66,62,62,66,99,236,237,66,66,66,66,66,66,66,66,66,46,46,237,66,66,46,237,236,237,46,19,66,237,236,237,46,237,236,99,19,64,99,99,237,99,99,64,237,217,46,46,46,66,181
170,171,66,247,9,247,19,99,99,66,246,66,62,19,62,56,46,66,66,246,247,62,64,64,19,62,62,19,66,66,62,99,247,217,99,246,247,246,247,246,247,66,66,19,46,46,237,246,247,66,46,46,89,89,89,19,66,246,46,46,46,66,46,99,247,19,99,64,246,247,99,64,245,247,46,99,247,66,66,99
180,181,66,237,9,64,19,99,99,66,46,66,88,19,46,46,46,66,46,64,64,62,62,236,66,236,19,66,64,246,246,99,237,227,237,66,237,237,237,237,66,46,237,46,19,19,237,46,46,46,237,237,237,236,237,19,66,66,237,66,66,140,140,99,99,19,140,237,236,237,99,99,255,237,46,46,46,66,99,181
170,171,66,247,9,247,19,99,66,66,66,46,66,46,46,46,46,66,46,46,247,246,247,66,66,19,66,246,64,64,64,66,247,246,247,99,66,142,46,66,46,246,247,246,19,46,46,246,247,66,148,147,66,246,19,246,247,64,89,89,247,236,237,99,236,19,236,237,246,247,99,264,265,46,246,247,46,66,66,171
180,181,66,237,9,237,99,99,66,66,66,236,19,99,99,99,99,99,99,99,66,46,66,66,19,19,89,246,66,66,66,99,237,237,46,46,99,66,66,66,46,46,46,46,46,64,64,19,64,66,64,64,66,19,64,64,64,237,237,236,89,99,99,237,246,19,246,247,236,237,140,140,46,46,140,99,66,99,66,181
170,171,66,247,246,99,99,99,66,66,66,246,99,99,140,66,66,247,237,246,99,99,66,46,46,46,66,46,46,246,46,99,46,148,246,246,246,66,66,46,46,246,247,246,19,246,247,246,19,66,237,66,19,149,148,149,148,147,237,99,247,99,89,237,236,19,236,237,246,99,236,99,46,237,236,99,66,99,170,171
180,181,66,237,236,99,56,99,99,46,66,66,99,56,66,66,187,186,187,186,246,246,99,99,46,246,246,66,66,66,19,99,66,66,66,66,66,66,66,247,89,66,237,148,19,64,64,64,66,19,247,19,237,237,237,237,237,99,99,236,99,246,247,89,246,227,246,247,237,99,246,99,246,247,246,99,46,247,180,181
170,171,66,237,99,99,56,237,99,246,56,66,99,66,237,237,237,237,237,237,237,66,246,99,246,46,66,66,148,149,237,99,19,89,89,236,89,89,46,89,99,236,142,148,19,147,66,66,66,19,19,46,46,46,46,99,99,99,46,46,46,46,237,89,19,237,236,237,236,237,236,237,236,237,66,99,99,237,170,171
180,181,66,237,99,19,56,237,99,66,66,66,99,237,236,237,236,237,236,237,236,66,66,99,99,135,66,66,237,66,237,99,66,246,99,99,99,19,99,99,99,66,99,99,99,99,99,99,99,99,99,99,99,99,247,246,247,246,247,148,147,246,46,46,19,89,246,247,99,247,46,99,246,247,66,99,46,247,180,181
170,171,66,247,99,99,56,247,246,99,56,99,66,66,66,247,246,247,246,247,66,247,246,19,99,19,19,66,19,99,99,237,236,237,236,99,99,237,99,99,99,99,99,99,46,46,46,147,19,246,247,236,237,236,237,236,237,236,237,236,148,147,237,19,46,237,89,99,237,46,236,99,236,66,66,46,46,237,170,171
180,181,66,237,236,19,99,99,99,99,99,99,66,66,66,237,236,237,236,66,66,237,237,99,99,142,149,99,99,99,246,19,66,19,66,19,66,19,19,19,19,246,247,204,99,99,99,99,148,99,148,89,247,89,247,246,89,246,247,246,247,148,19,237,46,99,99,46,46,237,246,247,246,66,224,46,246,247,180,181
170,171,66,247,135,135,19,247,66,19,19,247,66,247,234,66,66,66,66,247,246,99,99,99,149,99,99,237,46,46,66,237,246,149,148,66,66,99,236,237,237,237,236,214,215,237,236,19,236,237,236,99,237,99,99,236,99,99,237,99,99,237,99,99,99,237,46,46,140,147,237,99,236,66,46,46,236,237,170,171
180,181,66,237,236,66,19,66,135,19,135,237,66,237,99,99,236,99,99,99,99,66,99,99,99,148,149,237,246,46,246,66,246,246,66,66,246,247,246,99,246,247,246,224,225,247,246,19,237,237,237,237,237,246,246,246,247,99,247,246,19,19,237,148,147,247,89,247,140,89,89,99,246,66,46,247,247,248,180,181
170,171,66,247,66,66,19,19,19,19,246,247,99,99,99,99,99,99,66,66,66,148,149,148,149,148,149,237,236,148,46,246,66,66,66,237,236,237,236,237,236,237,99,237,236,237,236,237,19,237,236,237,236,246,246,246,246,148,19,19,237,236,99,237,148,148,148,149,140,140,99,46,46,66,237,236,257,258,170,171
180,181,237,66,66,237,237,237,237,237,66,66,66,66,66,66,66,66,66,66,66,66,66,148,66,66,149,66,66,148,148,46,66,66,66,247,246,247,246,247,246,247,246,247,99,247,246,247,246,19,19,19,246,19,19,19,246,19,148,246,247,246,247,237,148,148,148,99,46,46,99,140,147,66,247,246,267,268,180,181
170,171,140,66,66,140,66,140,66,140,66,66,140,66,66,66,66,66,66,66,66,66,66,66,66,66,66,66,66,66,66,66,46,66,46,66,66,66,46,46,66,46,46,46,66,46,46,66,99,46,66,46,46,46,46,66,66,46,66,46,66,66,46,66,46,66,46,66,140,66,99,66,66,99,140,140,140,99,170,99
180,181,141,66,66,141,141,141,141,141,141,141,141,141,141,141,141,141,141,141,141,141,141,141,141,141,141,141,141,141,141,141,141,141,66,141,66,66,66,66,66,141,141,141,141,141,141,141,141,141,141,141,99,141,141,141,141,141,141,141,141,141,141,141,141,141,141,141,141,99,99,141,141,141,141,141,141,141,180,181