170,171,186,187,186,187,186,187,186,187,186,187,186,187,186,187,186,187,186,187,186,187,186,187,186,187,186,187,186,187,186,187,186,186,187,186,186,186,186,187,186,187,186,186,186,187,186,186,186,186,187,186,186,186,186,187,186,186,186,186,187,186,186,186,186,186,186,187,186,186,186,186,187,186,186,187,186,187,170,171
180,181,237,237,237,237,237,237,237,237,237,237,237,237,237,237,237,237,237,237,237,237,237,237,237,237,237,237,237,237,237,237,237,237,237,237,237,237,237,237,237,237,237,237,237,237,237,237,237,237,237,237,237,237,237,237,237,237,237,237,237,237,237,236,237,236,237,236,237,236,237,236,237,236,237,236,237,237,180,181
170,171,237,236,237,236,237,236,234,235,237,236,237,236,237,236,237,236,237,236,237,236,237,236,237,236,237,236,237,236,237,236,237,236,237,236,237,236,237,236,237,236,237,236,237,236,237,236,237,236,237,236,237,236,237,236,237,236,237,236,237,236,237,246,247,246,217,246,247,246,247,246,247,246,247,246,247,237,170,171
180,181,237,246,247,246,247,246,244,245,247,246,247,217,247,246,247,246,247,246,247,246,247,217,247,246,247,246,247,246,247,246,247,217,247,246,247,246,247,246,247,217,247,246,247,246,247,246,247,246,217,246,247,246,247,246,247,246,247,246,247,246,247,236,237,236,227,236,237,236,237,236,237,236,237,236,237,237,180,181
170,171,237,236,237,236,237,236,254,255,237,236,237,227,237,236,237,236,237,236,237,236,237,227,237,236,237,236,237,236,237,236,237,227,237,236,237,236,237,236,237,227,237,236,237,236,237,236,237,236,227,236,237,236,237,236,237,236,237,236,237,236,237,246,247,246,247,246,247,246,247,246,247,246,247,246,247,248,170,171
180,181,237,246,247,246,247,246,264,265,247,246,247,246,247,246,247,246,247,246,247,246,247,246,247,246,247,246,247,246,247,246,247,246,247,246,247,246,247,246,247,246,247,246,247,246,247,246,247,246,247,246,247,246,247,246,247,246,247,246,247,246,247,140,140,140,140,140,140,140,237,236,237,236,237,236,257,258,180,181
170,171,237,236,237,236,140,140,140,140,140,140,140,140,140,140,140,140,140,22,22,22,140,22,22,22,22,22,22,140,140,140,140,140,140,140,140,140,140,140,140,140,140,140,140,140,140,140,140,140,140,140,140,140,147,237,237,236,237,236,237,140,140,140,140,140,140,140,140,140,140,246,247,246,247,246,267,268,170,171
180,181,237,246,247,246,247,237,237,237,237,237,237,237,237,237,237,22,237,237,237,237,237,237,237,237,237,237,22,237,237,237,237,237,237,237,22,22,22,22,237,237,237,237,237,237,237,237,237,237,237,237,237,140,140,147,237,246,247,246,247,236,237,236,237,236,237,237,236,237,236,237,236,237,236,237,140,140,180,181
170,171,140,236,237,236,237,236,237,236,237,236,237,236,22,22,22,236,237,236,237,236,237,236,237,236,237,236,22,236,237,46,46,46,46,22,22,46,237,236,22,22,22,236,237,236,237,236,237,236,237,236,237,236,237,140,22,22,22,22,237,246,247,246,247,246,247,237,246,247,246,247,246,247,246,247,140,140,170,171
180,181,140,140,247,246,247,246,247,22,247,246,247,22,22,246,247,246,247,246,247,246,247,246,247,246,247,22,22,246,247,46,247,246,22,22,247,246,247,46,46,246,247,22,247,246,247,246,247,246,247,246,247,246,247,22,140,147,237,22,237,236,237,236,237,278,279,237,236,237,236,237,236,237,140,140,140,140,180,181
170,171,140,140,237,237,237,237,237,22,237,236,237,22,237,236,237,236,237,22,22,22,22,22,237,236,237,22,237,236,237,46,237,22,22,22,22,22,217,236,237,46,237,230,22,22,233,236,237,236,237,217,237,236,22,237,237,140,140,22,22,246,247,246,247,288,289,237,246,247,246,247,246,247,140,140,140,140,170,171
180,181,140,140,140,140,140,140,22,22,247,22,22,246,247,46,22,22,22,246,247,246,247,246,22,246,22,246,247,246,247,46,247,22,247,22,22,22,22,246,247,246,46,46,241,242,22,22,247,246,22,22,22,22,22,22,22,236,237,236,22,236,237,237,237,237,237,237,237,237,237,237,140,140,140,140,140,140,180,181
170,171,237,236,237,236,237,236,237,22,140,22,237,236,22,22,140,236,237,236,237,236,22,236,237,22,22,236,237,236,237,46,237,22,237,236,22,22,237,22,22,236,237,250,46,252,253,236,237,22,22,236,22,236,237,236,237,22,22,246,22,246,247,237,142,140,140,237,246,247,237,140,140,140,140,140,140,140,170,171
180,181,237,246,217,246,247,22,22,22,22,246,247,22,22,246,140,246,247,246,247,246,22,246,22,22,247,246,247,246,247,46,247,22,247,246,247,22,247,246,22,22,247,260,261,46,263,246,247,246,22,22,22,246,247,246,247,236,237,22,22,22,237,142,140,237,236,237,236,237,236,237,236,237,236,237,236,237,180,181
170,171,237,236,227,236,237,22,237,22,22,236,237,22,46,248,140,140,140,140,140,140,22,140,22,22,237,237,237,237,140,46,237,22,237,237,237,140,22,140,140,140,22,140,140,140,46,140,140,22,140,140,22,22,237,237,237,246,247,246,22,22,142,140,237,237,246,247,246,247,246,247,246,247,246,247,246,247,170,171
180,181,237,246,247,246,247,246,247,22,247,246,22,22,46,258,140,236,237,236,237,22,237,236,22,22,217,236,237,236,140,140,237,22,237,236,237,236,22,236,237,236,237,22,237,236,237,46,237,22,22,236,237,236,22,217,237,236,237,237,237,22,140,237,236,237,236,237,236,237,236,237,236,237,236,237,236,237,180,181
170,171,237,237,237,237,237,22,237,22,237,237,22,237,46,268,140,246,247,246,247,22,234,235,22,22,22,22,247,22,140,22,247,22,247,22,247,22,247,22,22,22,247,22,22,22,247,22,22,22,22,22,22,22,22,22,247,246,247,237,142,22,237,237,246,247,246,247,246,247,246,247,246,247,246,247,246,247,170,171
180,181,237,236,247,236,247,22,237,22,247,140,22,140,46,140,140,236,237,236,22,236,244,22,22,22,22,236,247,248,140,46,140,22,237,236,237,236,237,22,237,236,237,236,22,22,237,236,22,236,237,236,237,236,237,22,237,237,237,142,140,237,22,237,236,237,236,237,236,237,236,237,236,237,236,237,236,237,180,181
170,171,237,237,237,237,237,237,237,22,237,237,22,237,46,237,237,246,247,246,22,246,254,22,22,246,22,246,257,258,140,46,140,22,247,246,247,246,247,246,22,246,247,236,237,22,247,246,22,46,247,246,247,246,22,22,247,237,142,140,237,237,22,247,237,237,237,237,237,237,237,247,246,247,246,247,246,247,170,171
180,181,236,237,236,237,236,22,236,22,236,237,22,237,46,237,236,237,236,22,236,237,264,265,22,237,22,237,267,268,46,140,140,22,237,237,237,237,237,236,237,236,237,246,247,22,237,22,22,46,237,237,22,22,22,237,237,142,140,237,237,237,22,237,237,237,237,237,237,237,237,237,237,237,236,237,236,237,180,181
170,171,246,247,246,247,246,22,246,22,246,247,22,247,46,247,246,247,246,22,246,247,140,187,186,22,22,22,186,187,46,187,186,22,186,149,149,148,237,246,22,246,247,246,247,22,247,22,247,46,46,22,22,149,186,187,186,187,186,187,186,187,186,22,186,187,186,187,186,187,186,187,186,187,246,247,246,247,170,171
180,181,236,237,236,237,236,22,237,22,236,237,22,237,46,237,236,237,237,22,237,237,140,236,237,22,22,22,237,22,46,236,237,22,237,236,237,236,237,236,22,236,237,237,237,22,237,22,22,22,22,236,237,236,237,236,237,236,237,236,237,236,237,22,237,236,237,237,236,237,236,237,236,237,236,237,236,237,180,181
170,171,246,247,246,247,246,247,22,22,22,247,22,247,46,247,246,247,22,22,140,140,140,246,22,22,247,22,247,46,46,246,22,22,247,246,247,246,247,246,247,246,247,149,148,22,237,22,22,246,46,246,247,246,247,246,247,246,247,246,247,246,247,22,247,246,247,237,246,247,246,247,246,247,246,247,246,247,170,171
180,181,236,237,217,237,236,237,140,22,236,22,22,237,236,46,236,237,22,236,237,236,22,22,237,22,237,236,22,236,237,236,237,22,237,236,237,236,237,236,22,237,148,237,22,237,22,22,237,46,237,236,237,236,237,236,237,236,237,236,237,236,237,22,237,236,237,237,236,237,236,234,235,237,217,237,236,237,180,181
170,171,246,247,227,247,246,247,22,22,246,247,246,22,22,22,22,22,22,22,247,22,22,246,247,246,247,46,22,22,247,246,247,22,247,22,247,246,247,246,22,237,237,22,22,22,22,22,46,46,247,246,247,246,247,217,247,246,247,246,247,246,22,22,247,246,247,237,246,247,246,244,245,247,227,247,247,248,170,171
180,181,236,237,236,237,236,237,140,22,237,236,237,22,237,236,46,46,22,46,237,236,237,236,22,46,46,236,288,22,22,236,22,227,237,236,237,237,237,237,22,237,22,236,237,22,237,22,237,237,237,237,237,236,237,227,237,236,237,236,237,140,22,22,140,140,140,237,236,237,236,254,255,237,236,237,257,258,180,181
170,171,246,247,246,247,246,247,140,22,22,246,247,140,22,246,247,246,247,22,46,46,46,46,46,217,247,246,247,246,22,22,22,246,247,246,247,142,22,237,22,22,22,246,22,22,247,22,247,237,148,147,237,246,247,246,247,246,247,246,247,236,22,22,236,237,236,237,246,247,246,264,265,247,246,247,267,268,170,171
180,181,236,237,236,237,236,237,140,236,22,236,237,140,140,22,236,237,237,22,22,22,237,22,237,227,237,236,237,236,22,22,22,22,22,22,22,22,22,22,22,22,237,236,22,22,22,22,237,149,237,148,147,237,237,237,237,237,237,236,237,22,22,22,246,247,246,247,236,237,140,140,140,140,140,140,140,140,180,181
170,171,246,247,246,247,246,247,140,246,247,22,22,140,140,140,22,247,237,246,247,246,22,22,22,22,22,22,22,22,22,142,149,148,22,148,149,237,236,237,22,246,247,22,247,246,247,22,22,236,22,22,22,22,148,22,22,147,22,22,22,22,22,237,236,217,236,237,246,247,236,237,236,237,236,237,236,237,170,171
180,181,143,237,236,237,237,144,143,236,237,22,237,22,144,186,187,22,22,186,187,237,22,237,236,237,236,237,237,237,148,149,237,237,237,22,22,22,22,22,22,22,22,148,22,237,237,22,237,237,247,237,237,237,237,237,237,148,147,236,237,246,22,237,246,227,246,247,237,237,246,247,246,247,246,247,246,247,180,181
170,171,237,237,246,247,237,237,237,246,247,246,22,237,22,237,237,237,22,22,22,22,246,247,246,247,246,247,148,149,237,236,237,236,237,236,237,236,237,236,22,236,142,148,149,147,22,22,237,236,237,236,237,236,237,236,237,236,148,147,247,22,22,237,236,237,236,237,236,237,236,237,236,237,236,237,236,237,170,171
180,181,236,237,236,237,236,237,236,237,204,205,22,237,236,22,22,237,236,237,22,237,22,237,22,22,236,236,237,237,237,246,247,246,247,246,247,246,247,246,22,142,148,246,247,149,147,246,247,246,247,246,247,246,247,246,247,246,247,148,22,22,247,237,246,247,246,247,246,247,246,247,246,247,204,205,246,247,180,181
170,171,246,247,246,247,246,247,246,247,214,215,246,22,246,247,246,22,246,22,246,247,246,247,246,247,22,22,22,22,22,22,236,237,236,237,236,237,22,22,22,22,22,22,237,236,149,147,237,246,247,236,237,236,237,236,237,22,22,22,148,147,237,237,236,237,237,237,237,237,236,237,236,237,214,215,236,237,170,171
180,181,236,237,236,237,236,237,236,237,224,225,236,237,22,237,236,22,22,22,22,22,22,22,22,142,22,22,22,22,22,22,22,22,22,22,22,22,22,22,148,246,247,22,22,246,247,149,148,148,148,246,247,206,22,22,22,246,247,246,247,148,147,237,246,247,237,237,147,237,246,247,246,247,224,225,246,247,180,181
170,171,246,247,246,247,246,247,246,247,246,247,246,247,234,22,22,22,246,247,246,247,237,142,149,148,149,237,236,237,236,237,246,149,148,246,246,246,236,237,237,237,236,214,22,22,22,22,236,22,22,22,237,22,148,236,237,236,237,236,237,237,148,147,236,237,237,247,140,147,237,237,236,237,236,237,236,237,170,171
180,181,236,237,236,237,236,237,236,237,236,237,236,237,244,245,236,237,237,237,237,142,149,148,149,148,149,237,246,247,246,246,246,246,246,247,246,247,246,247,246,247,246,224,225,247,246,247,237,237,237,237,237,246,246,246,247,246,247,246,247,237,237,148,147,247,237,247,140,140,147,237,246,247,246,247,247,248,180,181
170,171,246,247,246,247,246,247,246,247,246,247,246,247,254,255,246,247,237,142,149,148,149,148,149,148,149,237,236,148,148,246,246,246,246,237,236,237,236,237,236,237,236,237,236,237,236,237,236,237,236,237,236,246,246,246,246,148,148,236,237,236,237,237,148,148,148,149,140,140,140,147,237,236,237,236,257,258,170,171
180,181,237,237,237,237,237,237,237,237,237,237,237,237,264,265,237,237,142,149,148,149,148,148,149,148,149,237,246,148,148,246,246,246,246,247,246,247,246,247,246,247,246,247,246,247,246,247,246,247,246,247,246,246,246,246,246,148,148,246,247,246,247,237,148,148,148,148,140,140,140,140,147,246,247,246,267,268,180,181
170,171,140,140,140,140,140,140,140,140,140,140,140,140,140,140,140,140,140,140,140,140,140,140,140,140,140,140,140,140,140,140,140,140,140,140,140,140,140,140,140,140,140,140,140,140,140,140,140,140,140,140,140,140,140,140,140,140,140,140,140,140,140,140,140,140,140,140,140,140,140,140,140,140,140,140,140,140,170,171
180,181,141,141,141,141,141,141,141,141,141,141,141,141,141,141,141,141,141,141,141,141,141,141,141,141,141,141,141,141,141,141,141,141,141,141,141,141,141,141,141,141,141,141,141,141,141,141,141,141,141,141,141,141,141,141,141,141,141,141,141,141,141,141,141,141,141,141,141,141,141,141,141,141,141,141,141,141,180,181