170,171,186,187,62,62,62,62,62,62,62,62,62,187,186,187,186,187,186,62,186,187,186,187,186,187,186,187,186,187,186,187,99,186,187,186,186,52,52,187,186,187,186,52,186,187,52,186,99,186,187,186,186,186,186,187,186,186,52,52,187,186,186,186,52,52,186,187,186,186,186,186,187,186,186,187,186,187,170,171
180,62,62,62,62,237,237,62,62,62,62,62,62,62,62,62,62,62,237,62,237,237,237,237,237,237,237,237,237,237,237,99,99,237,237,237,237,237,52,52,99,237,52,237,237,52,99,99,99,52,237,237,237,237,237,237,237,237,237,237,52,237,237,236,52,236,52,236,237,236,237,236,237,236,237,52,237,237,180,181
62,62,62,62,62,62,62,62,62,62,62,62,62,62,62,62,62,62,62,62,62,236,237,236,237,236,237,236,237,236,237,99,237,236,237,236,237,236,237,52,99,52,52,99,52,52,99,236,237,52,237,236,237,236,237,236,237,236,237,236,237,52,52,52,247,246,52,52,247,246,247,246,247,246,247,52,247,237,170,171
62,62,62,62,62,62,62,62,62,62,62,62,62,62,62,62,62,62,62,62,62,44,247,217,247,246,44,246,247,246,247,99,99,217,99,99,247,99,99,99,52,52,247,52,247,246,247,246,247,52,217,246,247,246,247,246,247,246,247,246,247,246,247,52,237,236,227,52,237,236,237,236,237,236,237,236,52,237,180,181
62,62,62,62,62,62,62,62,62,62,62,62,62,62,62,62,62,62,62,62,62,236,237,227,237,236,44,236,237,99,99,99,237,99,237,236,237,236,237,236,52,52,52,236,237,236,237,236,237,44,44,44,44,44,44,44,44,44,44,44,44,236,52,246,247,52,52,246,52,246,247,246,247,246,247,246,247,248,170,171
62,62,62,62,62,62,62,62,62,62,62,62,62,62,62,62,62,62,62,62,62,246,247,99,247,44,44,99,247,246,99,246,247,246,247,246,247,246,247,246,52,52,247,246,247,246,44,44,44,52,247,246,247,246,247,246,247,246,247,246,44,44,44,140,140,140,140,52,52,52,237,236,237,236,237,236,52,52,180,181
62,62,62,62,62,62,62,62,62,62,62,62,140,62,62,62,62,62,62,62,156,156,156,156,44,44,140,140,140,140,99,140,140,140,140,140,140,140,140,140,52,52,140,140,44,44,44,140,140,52,52,140,140,140,147,237,237,236,237,236,237,52,44,140,140,140,140,140,52,140,52,52,247,246,247,246,267,52,170,171
62,62,62,62,62,62,62,62,62,62,62,62,62,62,62,62,62,62,62,156,156,237,237,237,156,156,237,237,237,99,99,237,237,237,237,237,237,237,237,52,237,52,44,44,237,237,237,237,237,52,52,237,237,140,140,147,237,246,247,246,247,52,44,236,237,236,237,237,52,237,236,237,236,52,236,52,140,140,52,181
62,62,62,62,62,62,62,62,62,62,62,62,62,62,62,62,62,62,62,156,99,99,237,44,237,156,237,236,237,99,237,236,237,236,156,236,237,236,237,236,237,44,44,236,237,236,237,236,237,52,237,236,237,236,237,140,147,237,237,237,52,246,44,246,247,246,247,237,52,247,246,247,246,247,246,247,140,140,170,171
62,215,215,215,62,62,62,62,62,62,62,62,62,62,62,62,62,62,156,156,62,246,99,44,247,156,247,246,156,156,156,246,247,156,156,246,247,246,247,52,44,44,99,52,247,246,247,246,247,52,52,52,247,246,247,237,140,147,237,236,52,236,44,44,237,278,279,237,52,237,236,237,236,237,140,140,140,140,52,181
62,215,215,215,62,62,62,62,62,62,62,62,62,62,62,62,62,62,156,62,237,236,44,99,99,156,237,236,99,236,237,156,237,156,237,236,237,236,52,44,44,236,237,52,231,44,44,44,44,44,44,44,44,44,44,237,237,140,140,52,247,246,247,44,247,288,289,237,52,247,246,247,246,247,140,140,140,140,170,52
180,99,99,99,56,99,140,46,46,140,247,246,247,246,247,246,247,99,156,156,247,44,247,246,247,246,99,99,247,246,247,246,156,246,247,246,247,246,44,44,56,56,247,44,44,44,44,44,247,44,44,227,247,246,247,44,44,236,237,52,237,236,237,44,237,237,237,237,52,237,237,237,140,140,140,140,140,140,180,52
99,99,237,99,56,56,237,236,46,140,140,236,237,236,237,140,156,156,156,156,156,156,237,236,237,236,237,99,237,236,237,156,156,236,237,236,237,52,44,236,52,44,44,44,44,44,44,44,44,44,44,44,44,44,44,236,237,44,52,246,247,246,247,44,142,140,140,52,246,247,237,140,140,140,140,140,140,140,170,52
180,99,99,246,217,56,247,246,247,46,247,246,247,246,247,246,140,156,156,156,156,156,156,88,247,99,99,246,44,44,156,156,44,44,247,246,247,44,52,246,247,44,44,56,44,44,263,246,247,52,44,44,52,246,44,44,44,236,44,236,237,237,237,44,140,237,236,52,236,237,236,237,236,237,236,237,236,237,180,52
99,171,237,236,227,56,237,236,237,88,88,46,237,236,247,248,156,156,56,140,156,156,156,156,156,156,156,156,156,156,156,237,237,237,44,237,237,44,140,140,44,44,44,44,44,44,44,44,44,44,44,44,52,237,237,237,44,44,247,44,247,237,142,44,237,237,52,247,246,247,246,247,246,247,246,247,246,247,170,171
180,181,237,246,247,56,247,246,247,246,88,88,247,246,156,156,156,99,56,44,237,156,156,156,156,156,44,156,156,99,140,51,237,236,44,44,44,44,237,44,237,44,237,56,237,99,52,236,237,52,44,236,44,236,237,217,52,44,44,44,237,142,140,44,44,52,236,237,236,237,236,237,236,237,236,237,236,237,180,181
99,99,99,99,99,99,99,99,99,99,99,99,99,237,99,99,99,99,44,44,99,156,234,156,156,44,156,88,247,99,51,140,247,246,247,44,44,52,44,246,44,44,56,99,99,99,247,246,247,52,247,44,44,44,44,44,44,44,44,44,44,140,237,237,44,247,246,247,246,247,246,247,246,247,246,247,246,247,99,99
99,181,237,236,247,236,56,237,237,52,52,140,140,99,52,99,99,99,44,236,56,156,156,44,156,236,237,88,99,99,51,140,140,236,44,44,44,44,44,44,52,44,237,236,99,99,52,99,44,44,44,236,44,52,52,236,237,237,44,142,44,44,44,44,44,44,236,52,236,237,236,237,236,237,236,99,99,237,99,181
99,99,99,237,237,237,56,237,237,237,237,237,237,88,46,237,88,99,44,99,247,56,156,156,247,246,106,106,99,106,99,99,44,99,99,99,44,44,99,99,99,44,44,99,99,44,44,44,52,52,99,99,44,44,99,99,99,99,44,99,99,44,52,44,44,44,237,52,99,99,237,99,99,247,99,247,246,52,52,52
180,181,99,99,99,237,56,237,236,237,236,237,236,88,236,88,236,99,44,99,99,237,156,265,106,106,106,99,267,268,99,44,140,140,237,44,52,44,44,236,52,56,44,52,44,44,237,52,237,52,237,56,44,44,99,99,99,99,44,237,237,44,237,237,44,237,44,52,52,237,237,237,237,237,236,52,52,52,180,181
170,171,99,99,99,247,99,247,246,247,246,247,246,247,88,88,246,44,246,247,99,99,44,106,106,187,99,88,99,44,44,187,186,187,186,44,149,44,44,52,52,246,44,44,44,246,247,99,52,52,99,148,44,52,44,187,186,187,44,52,99,99,44,99,186,44,44,52,52,52,186,187,186,52,52,247,99,247,170,171
180,181,236,99,99,237,236,99,99,237,236,237,236,237,236,88,236,44,237,106,106,106,44,99,99,99,99,99,99,44,99,99,99,56,56,44,52,44,44,236,56,44,44,44,44,237,237,237,52,236,99,99,44,52,44,236,237,236,44,236,237,236,44,99,99,44,44,44,99,52,52,52,52,237,99,99,99,237,180,181
170,171,246,99,99,247,246,56,140,99,52,247,246,247,246,88,246,44,106,106,106,106,44,99,99,246,247,88,44,51,51,246,247,99,56,44,52,44,44,56,247,44,44,44,44,44,44,44,44,44,44,99,44,52,44,246,247,44,44,246,247,246,44,246,247,246,44,44,246,247,99,99,99,99,99,247,246,247,170,171
180,181,236,99,99,237,236,237,56,140,236,52,106,106,236,88,44,44,106,46,99,99,44,236,56,236,237,56,44,236,237,236,237,56,44,56,44,44,44,236,237,44,44,44,236,237,149,52,52,99,44,99,44,236,44,52,52,44,237,236,237,236,237,44,237,236,44,44,44,237,236,234,235,237,217,237,236,237,180,181
170,171,246,99,99,247,246,247,56,237,246,52,52,52,246,88,44,99,99,99,99,46,44,246,56,246,56,51,51,88,247,56,247,217,44,99,44,44,52,44,247,237,44,44,246,247,237,52,247,99,44,246,44,44,247,56,44,246,247,246,247,246,247,44,247,246,247,44,44,247,246,244,245,247,227,247,247,248,170,171
180,181,236,99,99,237,236,237,140,56,237,236,237,99,52,52,44,99,99,99,106,106,44,236,56,236,88,51,44,88,237,236,237,227,44,99,44,44,52,44,237,237,44,44,44,44,237,52,237,237,44,44,99,44,237,44,44,236,237,236,237,140,140,44,140,140,140,44,44,52,236,254,255,237,236,237,257,258,180,181
170,171,246,99,99,99,99,99,99,99,99,99,99,99,99,99,44,246,99,106,106,106,44,44,56,217,51,51,44,246,247,246,247,44,247,99,44,142,44,44,237,246,44,44,247,44,44,246,247,44,148,44,99,44,44,56,247,246,247,246,247,236,237,44,44,44,44,44,44,52,52,264,265,247,246,247,267,268,170,171
180,181,236,99,99,237,236,237,140,236,56,56,237,99,99,99,44,237,106,88,106,106,106,44,44,51,51,44,237,236,237,237,237,44,56,99,44,149,44,52,44,236,44,44,237,236,52,44,44,44,44,44,44,44,237,237,56,237,237,236,237,246,247,44,44,247,246,44,44,44,52,140,140,140,140,140,140,140,180,181
170,171,246,99,99,247,246,247,140,52,247,246,99,99,140,44,88,247,106,106,106,106,106,88,44,44,88,44,247,246,247,142,44,44,56,148,44,237,236,44,44,52,44,44,247,246,52,44,44,44,44,44,52,149,148,149,56,147,237,246,247,236,237,44,44,217,236,52,44,44,44,237,236,237,236,237,236,237,170,171
180,181,143,99,99,237,237,144,143,52,237,99,99,143,56,44,187,88,88,99,106,106,106,51,51,88,44,44,44,44,44,44,237,237,237,237,52,44,246,44,44,52,44,44,44,52,44,237,44,44,44,44,99,52,237,237,56,148,147,236,237,246,247,44,44,227,246,52,44,44,44,44,246,247,246,247,246,247,180,181
170,171,237,99,99,247,237,237,237,246,247,99,247,237,237,44,56,56,56,56,99,106,106,51,88,88,246,44,56,149,237,236,237,236,237,236,52,44,237,56,44,44,44,44,44,44,237,44,44,44,44,236,99,99,52,236,56,236,148,147,247,236,237,44,44,237,236,44,44,44,52,44,236,237,236,237,236,237,170,171
180,181,236,99,99,237,236,237,236,237,99,99,236,237,236,44,44,237,236,99,236,106,51,51,88,237,236,236,44,56,237,246,247,56,56,246,52,56,44,56,56,44,44,44,44,44,44,44,44,99,247,246,99,99,247,52,52,52,247,148,147,246,247,44,44,247,246,44,52,44,52,44,246,247,204,205,246,247,180,181
170,171,246,247,99,247,246,247,246,247,99,215,246,247,246,247,44,247,246,247,135,99,51,51,51,51,51,51,51,44,44,52,52,237,236,237,99,237,237,44,142,44,44,56,44,236,44,44,99,99,247,99,237,236,99,236,56,52,237,236,148,147,237,44,236,44,237,44,52,44,44,44,236,237,214,215,236,237,170,171
180,181,236,237,99,237,236,237,236,237,99,225,236,237,236,237,44,44,236,237,135,99,99,99,99,99,99,99,99,99,44,44,44,44,44,44,44,44,44,44,44,44,44,44,44,44,247,99,148,148,99,99,247,206,99,246,56,52,247,246,247,148,44,44,246,247,44,44,52,237,44,247,246,247,224,225,246,247,180,181
170,171,246,247,99,99,246,247,246,99,99,247,246,247,234,235,246,44,44,247,99,99,99,142,149,56,56,56,236,237,236,99,99,99,148,246,52,52,52,56,237,44,236,214,215,44,44,237,236,99,99,247,237,149,148,99,237,52,237,236,237,44,44,147,236,237,237,247,52,147,52,237,236,237,236,237,236,237,170,171
180,181,236,237,99,99,236,99,236,99,236,237,236,237,244,245,236,237,237,44,44,99,99,148,56,56,149,237,246,247,246,246,246,246,52,52,99,99,51,56,44,247,246,224,225,99,56,44,52,52,237,237,237,246,246,99,247,52,247,44,44,44,237,148,147,247,237,247,140,52,52,237,246,247,246,247,247,248,180,181
170,171,246,247,99,99,246,247,246,99,246,247,246,247,254,255,246,247,237,99,106,44,44,44,56,148,149,237,52,148,52,246,52,52,246,52,99,237,99,44,44,237,236,237,52,52,52,237,99,44,236,44,44,44,44,44,44,44,44,236,237,236,237,237,148,148,148,149,140,52,52,147,237,236,237,236,257,258,170,171
180,181,237,237,99,237,99,237,237,99,237,237,237,237,264,265,237,237,142,149,106,99,106,99,44,44,44,44,44,44,148,246,99,99,99,52,99,99,99,44,99,99,99,99,99,247,246,99,246,52,52,247,246,246,56,246,99,52,52,246,247,246,247,237,148,148,148,148,140,52,52,140,147,246,247,246,267,268,180,181
170,171,140,140,99,140,99,99,99,99,140,140,140,140,140,140,140,140,140,106,106,106,99,135,99,140,56,140,99,99,44,44,44,44,44,44,44,44,44,51,51,99,99,140,99,99,99,99,140,140,140,140,56,56,140,140,99,52,52,140,140,140,140,140,140,140,140,140,140,52,52,140,140,140,140,140,140,140,170,171
180,181,141,141,99,141,141,99,141,99,99,141,141,141,141,141,141,141,141,99,106,106,99,135,141,99,99,99,56,141,141,141,141,141,141,141,99,141,141,141,51,99,141,99,99,99,141,141,99,99,99,56,141,141,141,52,99,52,141,141,141,141,141,141,141,141,141,141,141,141,141,141,141,141,141,141,141,141,180,181