49,49,11,11,11,11,11,11,11,11,11,11,11,11,11,11,11,11,11,11,11,11,11,11,11,11,11,11,11,11,11,11,11,11,11,11,11,11,11,11,11,11,11,11,11,11,11,11,11,11,11,11,11,11,11,11,11,11,11,11,11,11,11,11,11,11,11,11,11,11,11,11,11,11,11,11,11,11,49,49
59,59,96,97,96,97,96,97,96,97,96,97,96,97,96,97,96,97,96,97,96,97,96,97,96,97,96,97,96,97,96,97,96,97,96,97,106,96,106,106,96,97,96,97,96,97,106,106,106,106,106,106,106,97,96,97,96,97,96,97,96,97,96,97,96,97,96,97,96,97,96,97,96,97,96,97,96,97,59,59
49,49,106,107,106,107,106,107,94,95,106,107,106,107,106,107,106,107,106,107,106,107,106,107,106,107,106,107,106,106,106,106,106,107,106,107,106,107,106,107,96,96,96,96,96,96,106,107,106,107,106,107,106,107,96,96,96,107,106,107,106,107,106,107,106,107,297,107,106,107,106,107,106,107,106,107,106,107,49,49
59,59,96,97,96,96,96,97,104,105,96,97,96,297,96,97,96,97,96,97,96,97,96,297,96,97,96,97,96,97,96,97,96,297,96,97,96,97,96,97,96,297,96,97,96,97,96,97,96,97,297,97,106,97,96,97,96,96,96,97,96,97,96,97,96,97,307,97,96,97,96,97,96,97,96,97,96,97,59,59
49,49,106,107,106,107,106,107,114,115,106,107,106,307,106,107,106,107,106,107,106,107,106,307,106,107,106,107,106,107,106,107,106,307,106,107,106,96,106,107,106,307,106,107,106,107,106,107,106,107,307,107,106,107,106,107,106,96,96,107,106,107,106,107,106,107,106,107,106,107,106,107,106,107,106,107,271,272,49,49
59,59,96,97,96,97,96,97,124,125,96,97,96,97,96,97,96,97,96,97,96,97,96,97,96,97,96,97,96,97,96,97,96,97,96,97,96,97,96,97,96,97,96,97,96,97,96,97,96,97,96,97,96,97,96,97,96,96,96,97,96,97,96,11,11,11,11,11,11,11,96,97,96,96,96,97,281,282,59,59
49,49,106,107,106,107,106,107,11,11,11,11,11,11,11,11,11,11,11,11,11,11,11,11,11,11,11,11,11,11,11,11,11,11,11,11,11,11,11,11,11,11,11,11,11,11,11,11,11,11,11,11,11,11,18,107,106,107,106,107,106,11,11,11,11,11,11,11,11,11,11,107,106,107,106,107,291,292,49,49
59,59,96,97,96,97,96,97,96,97,96,97,96,97,96,97,96,97,96,97,96,97,96,97,96,97,96,97,96,97,96,97,96,97,96,97,96,96,96,97,96,97,96,97,96,97,96,97,96,97,96,97,96,11,11,18,96,97,106,97,96,97,96,97,96,97,96,97,96,97,96,97,96,97,96,97,13,11,59,59
49,49,11,18,106,107,96,96,106,107,106,107,106,107,106,107,106,107,106,107,96,96,96,107,106,107,106,107,106,107,106,96,106,107,106,107,106,107,96,96,106,107,106,107,106,96,96,96,106,107,106,107,106,107,106,11,18,107,106,107,96,107,106,107,106,107,106,107,106,107,106,107,106,107,106,13,11,11,49,49
59,59,11,11,18,97,96,97,96,96,96,96,96,96,96,96,96,97,96,106,96,106,96,96,96,97,96,97,96,106,96,97,96,97,96,97,96,97,96,97,96,97,96,97,96,97,96,97,96,97,96,97,96,97,96,97,11,18,96,97,96,97,96,97,96,138,139,97,96,97,96,97,96,97,13,11,11,11,59,59
49,49,11,11,11,18,106,107,106,107,106,107,106,107,106,96,96,107,96,96,96,107,106,96,96,96,96,107,106,106,106,107,106,107,106,107,106,107,297,107,106,107,106,90,91,92,93,107,106,107,106,297,106,107,106,107,106,11,11,107,106,107,106,107,106,148,149,107,106,107,106,107,106,13,11,11,11,11,49,49
59,59,11,11,11,11,11,11,11,11,96,97,96,97,96,97,96,97,96,97,96,97,96,97,96,97,96,97,96,96,96,106,106,96,96,97,96,97,307,97,96,97,96,100,101,102,103,97,96,97,96,307,96,97,96,97,96,97,96,97,96,97,96,97,96,97,96,97,106,97,96,97,13,11,11,11,11,11,59,59
49,49,106,107,106,107,106,107,106,11,11,107,106,107,106,11,11,107,106,107,106,107,106,107,106,107,106,96,96,96,106,107,106,107,106,107,106,107,106,107,106,107,106,110,111,112,113,107,106,107,106,107,106,107,106,107,106,107,106,107,106,107,106,107,22,11,11,107,106,106,106,11,11,11,11,11,11,11,49,49
59,59,96,97,297,97,96,97,96,97,96,97,96,97,96,97,11,97,96,97,96,97,96,97,96,97,96,96,96,96,96,97,96,97,96,97,96,97,96,97,96,97,96,120,121,122,123,97,96,97,96,97,96,97,96,97,96,97,96,97,96,97,96,22,11,97,96,97,96,106,96,97,96,97,96,97,96,97,59,59
49,49,106,107,307,107,106,107,106,107,106,107,106,107,271,272,11,11,11,11,11,11,11,11,11,11,106,107,106,107,106,107,106,107,106,107,106,11,11,11,11,11,11,11,11,11,11,11,11,11,11,11,106,107,106,107,106,107,106,107,106,107,22,11,106,107,106,107,106,106,106,107,106,107,106,96,106,107,49,49
59,59,96,97,96,97,96,97,96,97,106,97,96,97,281,282,11,97,96,97,96,97,96,97,96,97,297,97,96,97,18,97,96,97,96,97,106,106,96,97,96,97,96,97,96,97,96,97,96,97,96,97,96,97,96,297,96,97,96,97,96,22,11,97,96,97,96,106,96,106,106,97,96,97,96,96,96,97,59,59
49,49,106,107,106,107,106,107,106,106,106,107,106,107,291,292,11,107,106,107,106,107,94,95,106,107,307,107,106,107,11,18,106,107,106,107,106,107,106,107,106,107,106,107,106,107,106,107,106,107,106,107,106,107,106,307,106,107,106,107,22,11,106,107,106,107,106,107,106,107,106,106,106,107,106,96,106,107,49,49
59,59,96,97,96,106,106,106,96,97,96,11,11,11,11,11,11,97,96,97,96,97,104,105,96,97,96,97,271,272,11,11,18,97,96,97,96,97,96,97,96,97,106,97,96,97,96,97,96,97,96,97,96,97,96,97,96,97,96,22,11,97,96,97,96,106,96,97,96,97,96,97,96,96,96,96,96,96,59,59
49,49,106,106,106,107,96,106,106,107,106,107,106,107,106,107,106,107,106,107,106,107,114,115,106,107,106,107,281,282,11,11,11,18,106,107,106,107,106,107,106,106,106,106,106,107,106,107,106,107,106,107,106,107,106,107,106,107,22,11,106,107,106,107,106,107,106,107,106,106,106,106,106,107,106,107,106,107,49,49
59,59,96,97,106,97,96,97,96,97,96,97,96,97,96,97,96,97,96,97,96,97,124,125,96,97,96,97,291,292,11,11,11,11,18,97,96,97,96,97,96,97,96,106,96,97,96,97,106,106,106,97,96,97,96,97,96,22,11,97,96,97,96,97,96,97,96,97,96,97,96,97,96,97,96,96,96,97,59,59
59,49,106,107,106,106,96,107,106,106,106,106,96,106,106,107,106,107,106,107,106,107,11,11,11,11,11,11,11,11,11,11,11,11,11,66,66,61,106,106,106,107,106,107,106,107,106,107,106,106,106,61,66,66,11,11,11,11,11,11,11,11,11,11,11,11,11,11,11,11,11,11,11,11,106,96,96,107,49,49
59,59,96,97,96,106,106,97,96,97,96,97,96,106,96,97,96,97,96,97,96,97,11,97,96,97,96,97,96,97,96,97,96,97,96,97,96,97,96,97,106,97,96,97,96,97,96,97,96,97,96,97,96,97,96,97,96,97,96,97,96,97,96,97,96,97,96,97,96,97,96,97,96,97,96,97,96,97,59,59
49,49,106,107,106,107,106,107,11,107,106,107,106,107,106,106,106,107,11,11,11,11,11,107,106,107,106,107,106,107,106,107,106,107,106,107,106,107,106,107,106,107,106,66,61,60,106,106,106,107,106,107,106,107,106,107,106,107,106,107,106,107,106,106,106,106,106,106,106,107,106,107,106,107,106,107,106,107,49,49
59,59,96,97,297,97,96,97,11,11,96,97,96,97,96,106,96,97,96,97,96,97,96,97,96,97,96,97,96,97,96,97,96,97,96,97,96,97,96,97,96,97,61,97,96,97,66,106,96,97,96,97,96,97,96,97,96,97,96,106,106,106,106,97,96,97,96,97,96,97,96,94,95,97,297,97,96,97,59,59
49,49,106,107,307,107,106,107,11,107,106,107,96,107,106,106,106,107,106,107,106,107,106,107,106,107,106,107,138,139,106,107,106,297,106,107,106,107,106,107,106,107,106,107,106,107,106,106,106,107,106,107,106,107,106,297,106,107,106,106,106,107,106,107,106,107,106,107,106,107,106,104,105,107,307,107,271,272,49,49
59,59,96,97,96,97,106,97,11,97,96,97,96,18,96,97,106,97,96,97,96,97,106,97,96,97,96,97,148,149,96,97,96,307,96,97,96,97,96,97,96,97,106,97,96,97,96,96,106,97,96,97,96,97,96,307,96,97,106,97,96,11,11,11,11,11,11,97,96,97,96,114,115,97,96,97,281,282,59,59
49,49,106,107,106,107,106,107,11,107,106,107,106,11,18,107,106,106,106,106,106,106,106,107,106,297,106,107,106,107,106,107,106,107,106,107,106,22,66,107,106,106,96,96,96,107,106,106,106,107,61,18,106,107,106,107,106,107,106,106,106,107,106,107,106,107,106,107,106,107,106,124,125,107,106,107,291,292,49,49
59,59,96,97,96,106,96,97,11,97,96,97,96,11,11,18,96,97,96,97,96,97,96,97,96,307,96,97,96,97,96,97,96,97,96,97,22,66,96,97,96,96,96,97,96,97,96,106,96,66,96,61,18,97,96,97,96,97,96,106,96,97,96,97,96,97,96,97,96,97,11,11,11,11,11,11,11,11,59,59
49,49,106,107,106,106,106,107,11,107,106,107,106,11,11,11,18,107,106,107,106,107,106,107,106,107,106,107,106,107,106,22,60,61,66,61,66,107,106,106,106,96,106,107,106,107,106,106,106,107,106,107,61,66,61,66,61,18,106,106,106,106,106,107,106,297,106,107,106,107,106,107,106,107,106,107,106,107,49,49
59,59,11,97,96,97,96,11,11,97,96,97,96,11,11,11,11,11,11,11,11,97,96,106,96,97,96,97,96,97,61,60,96,97,96,97,96,97,96,106,96,97,96,61,60,97,96,106,96,97,96,97,96,97,96,97,96,61,18,97,96,106,106,97,96,307,96,97,96,97,96,97,96,97,96,97,96,97,59,59
49,49,106,107,106,106,106,107,106,107,106,107,106,107,106,107,106,107,106,107,106,107,96,96,106,107,106,107,61,60,106,107,106,107,106,107,106,107,106,96,106,107,22,61,60,18,106,107,106,106,106,107,106,107,106,107,106,107,61,18,106,107,106,107,106,107,106,107,106,107,106,107,106,107,106,107,106,107,49,49
59,59,96,97,96,106,96,97,96,97,284,285,96,97,96,97,96,97,96,97,96,97,96,97,96,97,96,97,96,97,96,97,96,97,96,96,96,97,96,96,96,22,61,97,96,66,18,97,96,97,106,106,96,97,96,97,96,97,96,61,18,97,96,97,96,96,96,97,96,97,96,96,96,97,284,285,96,97,59,59
49,49,106,107,106,106,106,107,106,107,294,295,106,107,106,107,106,107,106,107,106,96,106,107,106,107,106,107,106,107,106,107,106,106,106,107,106,107,106,107,22,61,106,107,106,107,66,18,106,107,106,107,106,107,106,96,106,106,106,107,61,18,106,107,106,96,96,107,106,107,106,107,106,107,294,295,106,107,49,49
59,59,96,97,96,106,106,96,96,97,304,305,96,97,96,97,106,96,96,106,96,96,96,97,96,22,66,97,96,97,96,97,96,97,96,97,106,97,61,66,61,97,96,284,285,97,96,66,61,61,61,97,96,97,96,97,96,97,106,96,96,61,18,97,96,97,96,97,18,97,96,97,96,97,304,305,96,97,59,59
49,49,106,107,106,96,106,107,106,107,106,107,106,107,94,95,106,107,106,107,106,107,106,22,60,61,66,107,106,107,106,107,61,66,106,107,96,107,106,107,106,107,106,294,295,107,106,107,106,107,106,107,106,66,106,61,106,107,96,106,106,107,61,18,106,107,106,107,11,18,106,107,106,107,106,107,106,107,49,49
59,59,96,97,96,96,106,97,96,97,106,97,96,97,104,105,96,97,96,97,96,22,60,61,60,61,66,97,96,97,96,61,96,97,96,97,96,97,96,97,96,96,96,304,305,97,96,97,96,97,96,97,106,97,96,97,61,97,96,97,96,97,96,61,18,97,96,97,11,11,18,96,96,97,96,97,271,272,59,59
49,49,106,107,106,107,106,106,96,106,106,107,106,107,114,115,106,107,106,22,60,61,60,61,60,61,66,107,106,107,61,107,106,107,106,107,96,107,106,107,96,96,96,107,106,106,106,106,106,106,106,107,106,107,106,107,106,61,106,107,106,107,96,107,61,61,61,107,11,11,11,18,106,107,96,107,281,282,49,49
59,59,96,97,96,97,96,97,96,97,96,97,96,97,124,125,96,97,22,60,61,60,61,61,60,61,66,97,96,61,61,97,96,97,96,97,96,96,96,97,96,97,96,97,96,97,96,97,96,97,96,97,96,97,96,97,96,61,61,97,96,97,96,97,61,61,61,61,11,11,11,11,18,97,96,97,291,292,59,59
49,49,11,11,11,11,11,11,11,11,11,11,11,11,11,11,11,11,11,11,11,11,11,11,11,11,11,11,11,11,11,11,11,11,11,11,11,11,11,11,11,11,11,11,11,11,11,11,11,11,11,11,11,11,11,11,11,11,11,11,11,11,11,11,11,11,11,11,11,11,11,11,11,11,11,11,11,11,49,49
59,59,36,36,36,36,36,36,36,36,36,36,36,36,36,36,36,36,36,36,36,36,36,36,36,36,36,36,36,36,36,36,36,36,36,36,36,36,36,36,36,36,36,36,36,36,36,36,36,36,36,36,36,36,36,36,36,36,36,36,36,36,36,36,36,36,36,36,36,36,36,36,36,36,36,36,36,36,59,59