89,62,62,62,62,66,66,66,66,66,66,66,66,66
21,155,66,66,18,18,18,18,18,18,66,66,66,98,18,98,18,18,66,18,98,98,98,18,98,98,62,18,61,18,18,18,18,61,145,18,66,18,61,61,18,18,62,18,66,66,62,18,18,61,18,18,18,18,18,18,18,18,18,18,61,18,61,61,18,18,18,18,18,143,61,18,66,18,18,61,61,18,21,22
66,66,66,66,66,66,66,66,66,66,66,98,46,98,62,45,46,47,44,66,98,98,44,45,46,98,98,62,61,44,44,45,46,47,145,45,66,44,61,46,61,44,45,46,143,61,66,62,143,61,45,61,47,44,45,46,47,44,45,46,61,62,62,62,62,62,62,62,62,46,143,66,46,47,44,45,46,61,21,22
21,146,146,146,155,155,155,155,155,155,54,98,56,62,98,98,56,57,54,66,98,98,62,62,62,62,62,62,62,61,61,55,61,57,54,61,66,61,61,61,61,62,61,61,61,61,66,66,61,61,143,61,57,61,55,61,57,61,55,56,62,62,61,57,62,62,57,54,55,62,54,66,56,57,54,61,56,57,21,22
21,155,146,146,155,155,155,155,155,155,98,98,62,98,98,98,98,66,98,98,66,62,62,98,98,67,98,143,62,65,65,61,61,67,145,166,66,166,61,166,62,166,166,143,166,61,61,166,66,61,143,61,61,61,166,61,61,64,62,61,143,61,61,61,65,61,61,62,61,62,66,143,143,67,64,61,66,67,21,61
21,155,146,146,155,155,155,155,155,155,155,98,62,98,98,98,53,98,98,98,62,66,98,98,98,98,98,98,65,65,65,98,143,61,143,143,66,143,61,53,61,74,61,61,77,74,75,44,66,66,61,143,143,74,75,166,166,62,166,61,61,51,52,53,61,61,47,44,62,61,62,61,143,143,61,61,61,77,21,22
155,155,155,155,155,155,155,155,155,155,98,62,98,98,98,98,98,98,65,65,65,65,65,65,65,98,98,66,65,66,66,66,83,66,66,61,66,143,143,143,62,61,143,44,45,46,47,61,55,62,66,54,55,143,143,62,143,143,143,61,61,61,62,61,61,145,61,66,46,145,62,45,61,61,143,45,61,47,21,22
155,146,155,155,155,146,155,155,155,155,62,98,98,66,66,66,66,66,66,66,98,98,66,98,65,66,66,62,65,98,65,98,83,62,83,61,66,145,66,61,66,61,143,61,55,61,61,61,61,66,66,61,45,61,61,126,126,126,61,61,126,61,126,126,145,145,66,61,145,62,62,55,56,61,61,55,56,57,21,22
21,146,155,155,146,146,146,155,155,155,65,98,66,98,98,143,61,65,62,98,66,98,98,62,66,98,98,65,65,62,65,98,83,83,62,61,66,61,145,62,145,145,61,66,61,66,62,74,62,76,62,66,61,62,62,61,62,62,61,62,145,62,62,62,126,66,64,65,61,145,62,65,66,67,143,61,66,61,21,22
143,146,55,166,66,155,146,155,155,155,62,66,65,143,66,66,66,66,66,66,66,66,66,66,66,66,98,65,65,65,65,66,83,61,83,62,66,126,61,5,61,145,66,66,66,66,66,66,66,66,66,66,62,145,145,145,145,61,61,61,6,166,61,66,6,62,62,62,145,61,62,62,76,77,143,61,61,6,21,22
98,98,98,98,66,66,155,155,146,66,66,66,66,66,66,146,145,65,62,98,98,98,66,65,62,62,66,65,65,65,65,66,98,61,61,83,66,61,83,66,66,66,61,126,126,126,143,61,61,145,66,66,66,61,61,61,145,145,61,61,61,145,66,66,66,66,145,145,62,62,61,45,62,47,143,61,46,47,21,61
21,146,98,98,155,66,146,146,146,66,155,66,57,65,65,65,65,146,146,146,65,66,65,62,66,61,65,66,98,98,66,65,83,98,61,83,66,66,66,66,145,61,54,145,61,57,143,145,145,145,56,66,66,66,66,55,145,61,54,61,66,61,66,61,56,145,66,66,145,62,62,62,61,145,61,61,61,57,21,22
21,146,5,155,155,146,66,98,146,66,66,66,98,98,98,65,65,62,65,65,146,66,62,62,62,66,65,65,98,66,66,65,98,98,66,64,66,66,61,126,61,61,126,126,126,61,145,143,64,61,62,67,66,66,67,89,66,61,145,66,66,67,61,145,61,145,126,66,145,145,145,65,62,62,61,145,145,67,21,22
21,98,146,155,146,146,64,66,66,155,66,66,61,62,62,62,62,65,65,62,66,98,62,98,146,98,65,65,83,66,66,66,66,66,66,66,66,66,66,66,66,66,66,145,145,61,126,143,126,62,126,126,66,66,61,61,126,66,66,66,145,145,61,166,61,126,145,66,6,62,145,61,61,62,61,75,61,77,21,22
98,98,146,98,146,155,155,155,66,155,66,66,62,98,98,62,65,65,98,62,66,62,62,62,62,65,98,66,66,66,66,66,65,98,62,66,66,62,44,45,61,61,61,66,66,66,61,166,62,145,145,145,66,145,66,61,66,61,61,145,61,66,61,145,145,61,61,66,62,47,145,144,145,145,62,62,145,145,21,145
98,98,98,146,55,61,126,126,62,66,62,66,98,98,62,65,65,98,62,62,66,98,98,98,65,65,146,66,66,65,65,83,66,98,66,66,66,62,61,61,61,166,61,166,166,166,66,66,61,55,56,57,66,62,66,66,61,61,61,61,126,61,66,145,126,126,145,66,62,145,145,145,144,143,143,55,61,145,21,145
166,22,55,98,146,166,5,126,62,62,66,66,98,62,65,65,98,98,98,65,66,65,65,65,65,98,62,66,65,65,62,98,65,66,66,66,62,62,64,65,166,67,61,61,67,61,62,66,66,143,61,67,66,66,66,145,166,61,66,66,66,66,66,126,126,145,61,66,61,145,145,166,166,143,62,65,62,61,61,145
166,22,55,146,146,61,61,61,62,98,61,66,66,65,65,83,98,98,65,65,66,65,65,65,83,66,66,62,65,66,62,62,65,62,66,66,98,145,61,166,61,61,75,61,77,62,75,61,61,143,66,61,66,66,66,66,66,66,66,61,61,61,126,126,145,77,145,66,56,61,143,143,143,143,145,76,62,145,61,22
166,22,146,98,146,61,61,61,62,61,54,65,66,65,98,66,98,61,145,98,66,62,62,65,65,66,62,62,65,146,66,98,66,66,66,66,66,66,66,66,66,61,66,143,62,66,57,66,66,66,66,66,66,66,61,66,61,66,66,66,61,71,126,126,55,56,61,66,66,67,61,61,145,166,166,62,62,62,61,61
166,22,146,55,98,98,98,166,62,61,64,98,66,66,83,98,98,83,83,98,62,62,62,62,66,66,62,62,65,62,146,66,66,66,66,66,66,61,61,61,61,66,66,61,66,66,66,66,66,66,66,66,66,66,61,66,61,66,61,61,66,61,61,61,61,56,66,145,61,77,61,61,61,61,61,62,61,62,145,61
146,146,146,5,5,145,98,98,62,98,66,66,66,66,66,66,98,98,62,62,66,98,98,66,66,66,66,66,65,98,98,66,66,66,66,66,98,66,61,61,145,62,66,66,145,66,66,66,5,66,66,62,66,66,145,66,62,61,66,66,66,61,61,61,5,66,66,145,5,61,61,145,145,61,64,62,145,62,145,22
146,61,61,61,61,145,61,166,62,166,61,62,66,66,66,66,66,62,91,65,66,65,65,66,65,65,65,61,66,66,66,66,66,66,66,66,61,143,61,62,66,145,61,61,61,61,66,66,66,66,166,66,66,66,66,66,61,61,66,61,62,66,66,66,61,66,61,61,61,61,61,61,61,61,61,62,61,62,61,61
61,166,56,61,145,40,41,61,62,91,65,65,62,62,65,66,65,66,66,66,61,66,66,66,45,66,66,54,66,66,66,66,146,66,62,66,143,66,62,66,91,61,54,55,56,66,66,66,66,66,61,66,66,66,62,66,61,89,66,66,61,66,61,66,66,62,61,62,61,61,61,145,62,62,62,61,61,62,61,22
61,61,61,146,146,61,61,166,62,62,65,65,62,62,66,66,66,66,66,66,66,62,66,61,62,61,62,62,66,62,62,66,65,62,66,66,66,91,61,61,66,61,66,61,61,66,61,66,61,66,66,66,66,66,61,66,61,61,61,66,126,66,66,66,66,61,145,61,61,62,62,61,61,145,54,145,145,62,21,22
143,146,146,146,61,166,61,61,166,62,65,65,66,66,166,66,65,61,91,66,66,66,66,66,62,66,66,66,66,66,145,66,65,66,143,66,62,66,66,61,66,91,61,166,66,61,143,66,66,66,66,61,66,66,62,66,61,61,61,66,61,66,61,145,66,61,145,61,45,66,61,61,145,61,61,145,61,62,61,21
143,61,66,61,61,61,166,62,62,65,65,61,66,62,62,62,66,65,65,65,65,66,66,66,65,65,65,66,62,66,61,66,66,5,143,66,41,62,147,66,66,61,145,61,66,56,61,61,166,66,66,66,66,66,145,66,55,61,66,66,66,66,66,145,66,61,145,54,66,66,5,54,145,145,145,61,145,62,61,22
61,61,143,61,61,166,61,61,166,65,145,61,66,62,61,61,66,61,61,66,66,66,61,62,66,66,66,65,65,65,65,61,66,61,143,66,61,61,53,61,66,66,143,66,61,61,145,126,147,89,89,66,66,66,66,66,66,66,126,62,66,145,66,66,166,66,67,64,89,66,61,64,145,89,145,145,145,62,21,22
61,166,145,61,61,61,61,61,5,65,61,62,66,62,61,61,65,66,61,61,61,66,66,62,65,66,66,66,66,66,66,66,66,66,66,66,61,143,62,62,143,66,66,66,66,61,66,61,145,61,61,61,126,66,66,66,61,62,61,61,61,66,66,66,46,61,44,61,66,47,66,143,89,47,145,145,62,47,21,22
61,61,61,61,61,61,143,61,143,65,61,61,66,62,62,46,65,66,66,46,47,66,66,61,66,66,91,91,62,145,65,65,66,5,166,146,61,72,73,61,61,66,62,66,91,91,66,66,66,61,143,61,45,66,62,66,61,61,61,55,61,66,66,145,56,61,54,66,56,57,66,145,89,145,145,145,62,57,21,22
166,61,61,61,45,166,47,44,61,65,166,61,65,66,66,66,66,66,66,66,66,126,66,61,66,61,55,56,62,65,65,61,66,65,166,61,66,65,61,66,66,54,66,66,62,56,62,62,61,62,66,66,66,66,57,66,61,61,66,66,61,66,66,145,66,67,66,66,66,66,66,145,66,145,145,145,145,67,21,22
21,61,61,61,61,166,166,54,61,65,166,61,65,65,61,62,62,66,66,66,66,66,66,66,66,66,65,62,62,65,65,61,66,65,66,61,66,61,66,66,54,61,66,89,89,66,61,89,66,89,66,66,89,66,62,66,66,145,89,66,61,66,66,61,145,61,61,5,5,5,145,89,46,145,145,61,62,47,61,22
21,22,61,64,61,66,166,64,65,65,67,166,61,65,126,61,62,62,66,66,66,66,66,66,66,65,66,66,66,66,66,66,66,65,66,61,66,61,66,146,66,66,66,66,45,66,66,66,66,66,5,66,61,145,66,66,89,89,5,145,66,66,66,61,145,89,5,55,56,145,145,145,145,145,54,62,56,57,21,22
66,66,66,61,66,66,166,66,45,65,66,61,61,66,65,65,66,46,66,66,62,62,66,66,62,66,66,66,66,66,66,61,66,66,66,66,66,66,66,66,166,66,66,66,143,66,145,66,61,76,77,61,61,66,66,61,61,66,66,66,145,61,66,61,61,145,145,65,145,89,145,145,145,145,62,145,75,76,21,22
21,22,145,65,61,56,61,54,55,65,57,61,166,65,65,65,65,65,65,66,126,61,61,66,66,65,89,143,65,145,65,61,66,61,65,54,54,66,66,66,66,66,143,66,166,66,67,66,61,66,66,61,66,66,62,66,145,61,89,5,145,89,66,61,145,145,145,145,145,89,76,77,145,47,62,145,46,47,21,22
21,22,145,65,65,61,166,61,65,65,67,54,61,65,166,65,65,61,65,65,66,65,65,65,65,66,66,65,66,66,66,66,61,65,65,66,66,166,61,66,66,61,61,61,61,61,61,74,75,89,166,166,66,66,66,145,61,145,145,145,145,61,66,61,61,145,145,145,145,89,54,55,145,62,145,145,56,57,21,22
21,22,145,44,45,46,61,166,61,65,65,44,5,65,166,166,65,65,61,50,51,66,53,44,61,65,65,65,61,89,89,143,61,65,166,56,66,66,66,66,57,5,89,44,89,46,47,61,61,166,66,66,51,61,62,66,61,61,145,61,89,61,66,65,66,89,145,89,66,89,145,62,62,67,145,145,66,67,21,61
66,22,55,145,56,56,57,61,61,56,65,61,5,65,61,166,166,166,65,65,166,166,66,66,65,65,65,65,65,65,65,65,65,89,61,61,66,66,61,61,89,66,89,66,166,166,89,166,66,66,55,60,61,62,62,145,61,61,145,89,61,66,66,144,61,47,44,145,74,62,62,145,61,61,61,61,61,5,61,22
66,66,65,145,56,56,67,166,61,61,65,65,65,65,65,65,65,65,65,65,65,65,65,65,66,66,66,66,66,66,66,66,66,66,143,66,61,61,54,61,66,61,65,65,61,66,61,66,61,64,66,61,89,89,145,145,61,89,66,89,66,66,61,61,61,61,62,62,61,61,61,145,145,145,145,145,5,5,21,22
21,61,66,66,66,56,65,66,55,55,61,61,61,65,61,55,65,65,166,65,65,65,65,65,65,61,61,166,61,56,55,61,56,61,55,6,61,62,61,61,62,61,146,61,66,66,66,62,61,61,61,62,66,61,66,66,61,66,66,66,62,61,62,145,62,145,166,65,66,145,145,65,66,67,64,145,5,5,21,22
21,61,5,5,145,66,66,66,66,61,5,61,166,61,65,65,5,61,5,5,5,5,5,5,61,5,61,61,61,5,5,61,62,61,62,5,5,61,5,5,61,5,66,66,61,166,166,61,166,61,61,61,61,61,62,5,5,61,5,5,5,5,61,5,61,166,166,5,5,5,145,145,5,5,5,5,5,5,21,22
21,61,7,7,145,7,7,7,166,66,66,66,66,66,7,61,61,61,61,7,61,7,7,7,7,61,61,61,61,61,62,62,7,7,61,7,7,7,7,66,66,66,7,61,7,7,7,61,61,61,7,145,145,61,62,166,166,61,166,166,166,61,61,166,61,7,7,7,7,7,7,145,145,145,7,7,7,7,21,22