8,9,67,67,67,67,67,67,67,67,67,67,67,67,67,67,67,67,67,67,67,67,67,67,67,67,67,67,67,67,67,67,67,67,67,67,67,67,67,67,67,67,67,67,67,67,67,67,67,67,67,67,67,67,67,67,67,67,67,67,67,67,67,67,67,67,67,67,67,67,67,67,67,67,67,67,67,67,8,9
8,9,174,175,176,177,174,175,176,177,174,175,176,177,174,175,176,177,174,175,176,177,174,175,176,177,174,175,176,177,174,175,176,177,174,175,176,177,174,175,176,177,174,175,176,177,174,175,176,177,174,175,176,177,174,175,176,177,174,175,176,177,174,175,176,177,174,175,176,177,174,175,176,177,174,175,176,177,8,9
8,9,184,210,211,212,213,214,215,187,184,185,186,187,184,185,186,187,170,171,172,173,184,185,186,187,184,185,186,187,184,185,186,187,184,170,171,172,173,185,186,187,184,185,186,187,184,185,186,187,184,185,170,171,172,173,186,187,184,185,186,187,184,185,186,187,184,185,186,187,184,210,211,212,213,214,215,187,8,9
8,9,194,220,221,222,223,224,225,197,194,195,196,197,194,195,196,197,180,181,182,183,194,195,196,197,194,195,196,197,194,195,196,197,194,180,181,182,183,195,196,197,194,195,196,197,194,195,196,197,194,195,180,181,182,183,196,197,194,195,196,197,194,195,196,197,194,195,196,197,194,220,221,222,223,224,225,197,8,9
8,9,204,230,231,232,233,234,235,207,204,205,206,207,204,205,206,207,190,191,192,193,204,205,206,207,204,205,206,207,204,205,206,207,204,190,191,192,193,205,206,207,204,205,206,207,204,205,206,207,204,205,190,191,192,193,206,207,204,205,206,207,204,205,206,207,204,205,206,207,204,230,231,232,233,234,235,207,8,9
8,9,174,240,241,242,243,244,245,177,174,175,176,177,174,175,176,177,200,201,202,203,174,175,176,177,174,175,176,177,174,175,176,177,174,200,201,202,203,175,176,177,174,175,176,177,174,175,176,177,174,175,200,201,202,203,176,177,174,175,176,177,174,175,176,177,174,175,176,177,174,240,241,242,243,244,245,177,8,9
8,9,184,250,251,252,253,254,255,187,184,185,186,187,184,185,186,187,184,185,186,187,184,185,186,187,184,185,186,187,184,185,186,187,184,185,186,187,184,185,186,187,184,185,186,187,184,185,186,187,184,185,186,187,184,185,186,187,184,185,186,187,184,185,186,187,184,185,186,187,184,250,251,252,253,254,255,187,8,9
8,9,194,260,261,262,263,264,265,197,194,195,196,197,194,195,196,197,194,195,196,197,194,195,196,197,194,195,196,197,194,195,196,197,194,195,196,197,194,195,196,197,194,195,196,197,194,195,196,197,194,195,196,197,194,195,196,197,194,195,196,197,194,195,196,197,194,195,196,197,194,260,261,262,263,264,265,197,8,9
8,9,204,205,206,207,204,205,206,207,204,205,206,207,204,44,67,67,67,67,67,67,67,67,67,67,67,67,206,207,204,205,67,67,67,67,67,67,67,67,67,207,204,205,206,67,67,67,67,67,67,67,67,67,67,67,67,67,47,205,206,207,204,205,206,207,204,205,206,207,204,205,206,207,204,205,206,207,8,9
8,9,174,175,176,177,174,175,176,177,174,175,176,177,44,175,176,177,174,175,176,177,174,175,176,177,174,175,176,177,174,175,176,177,174,175,176,177,174,175,176,177,174,175,176,177,174,175,176,177,174,175,176,177,174,175,176,177,67,47,176,177,174,175,176,177,174,175,176,177,174,175,176,177,174,175,176,177,8,9
8,9,184,185,186,187,184,185,186,187,67,67,67,67,184,185,186,187,184,185,186,187,184,185,186,187,184,185,186,187,184,185,186,187,184,185,186,187,184,185,186,187,184,185,186,187,184,185,186,187,184,185,186,187,184,185,186,187,184,67,47,187,184,185,186,187,184,185,186,187,184,185,186,187,184,185,186,187,8,9
8,9,194,195,196,197,194,195,196,197,194,195,196,197,194,195,196,197,194,195,196,197,194,195,196,197,170,171,172,173,194,195,196,197,194,195,196,197,194,195,196,197,194,195,196,170,171,172,173,197,194,195,196,197,194,195,196,197,194,195,67,47,194,195,196,197,194,195,196,197,194,195,196,197,194,195,196,197,8,9
8,9,67,67,47,207,204,205,206,207,204,205,206,207,204,205,206,207,204,205,206,207,204,205,206,207,180,181,182,183,204,205,206,207,210,211,212,213,214,215,206,207,204,205,206,180,181,182,183,207,204,205,206,207,204,205,206,207,204,205,206,67,67,67,67,67,67,67,67,67,67,67,206,207,204,205,206,207,8,9
8,9,174,175,67,47,174,175,176,177,174,175,176,177,174,175,176,177,174,175,176,177,174,175,176,177,190,191,192,193,174,175,176,177,220,221,222,223,224,225,176,177,174,175,176,190,191,192,193,177,174,175,176,177,174,175,176,177,174,175,176,177,174,175,176,177,174,175,176,177,174,67,176,177,174,175,176,177,8,9
8,9,176,185,67,67,47,185,186,187,184,185,186,187,184,185,186,187,184,185,186,187,184,185,186,187,200,201,202,203,184,185,186,187,230,231,232,233,234,235,186,187,184,185,186,200,201,202,203,187,184,185,186,187,184,185,186,187,184,185,186,187,184,185,186,187,184,185,186,187,184,67,186,187,184,185,186,187,8,9
8,9,194,195,196,197,67,47,196,197,194,195,196,197,194,195,196,197,194,195,196,197,194,195,196,197,194,195,196,197,194,195,196,197,240,241,242,243,244,245,196,197,194,195,196,197,194,195,196,197,194,195,196,197,194,195,196,197,194,195,196,197,194,195,196,197,194,195,196,197,194,195,196,197,194,195,196,197,8,9
8,9,204,205,206,207,67,67,47,207,204,205,206,207,204,205,206,207,204,205,206,207,204,205,206,207,204,205,206,207,204,205,206,207,250,251,252,253,254,255,206,207,204,205,206,207,204,205,206,207,204,205,206,207,204,205,206,207,204,205,206,207,204,205,206,207,204,205,206,207,204,205,206,207,204,205,67,67,8,9
8,9,174,175,176,177,174,175,67,47,174,175,176,177,174,175,176,177,174,175,176,177,174,175,176,177,174,175,176,177,174,175,176,177,260,261,262,263,264,265,176,177,174,175,176,177,174,175,176,177,174,175,176,177,174,175,176,177,174,175,176,177,174,175,176,177,174,175,176,177,174,175,176,177,174,175,176,177,8,9
8,9,184,185,186,187,184,185,67,67,67,185,186,187,184,185,186,187,184,185,186,187,184,185,44,67,67,67,67,67,67,186,186,187,184,185,186,187,184,185,186,187,67,67,67,67,67,67,67,67,67,67,67,187,184,185,186,187,184,185,186,187,184,185,186,187,184,185,186,187,184,185,186,187,184,185,186,187,8,9
8,9,194,195,196,197,194,195,196,197,194,195,196,197,194,195,196,197,194,195,196,197,194,44,67,67,194,195,196,197,194,195,196,197,194,195,196,197,194,195,196,197,194,195,196,197,194,195,196,197,194,195,67,67,67,67,67,67,67,67,67,67,67,67,67,67,67,67,67,67,67,67,196,197,194,195,196,197,8,9
8,9,204,205,206,207,204,205,206,207,204,205,206,207,204,205,206,207,204,205,206,207,44,67,67,67,204,205,206,207,204,205,206,207,204,205,206,207,204,205,206,207,204,205,206,207,204,205,206,207,204,205,206,207,204,205,206,207,204,205,206,207,204,205,206,207,204,205,206,207,204,67,206,207,204,205,206,207,8,9
8,9,174,175,176,177,174,175,176,177,174,175,176,177,174,175,67,67,67,67,67,67,67,67,67,67,174,175,176,177,174,175,176,177,174,175,67,67,174,175,176,177,174,175,176,177,174,175,176,177,174,175,176,177,174,175,176,177,174,175,176,177,174,175,176,177,174,175,176,177,174,67,176,177,174,175,176,177,8,9
8,9,184,185,186,187,184,185,186,187,184,185,186,187,184,185,170,171,172,173,186,187,184,185,186,187,184,185,186,187,184,185,186,187,184,185,67,67,184,185,186,187,184,185,186,187,184,185,186,187,184,185,186,170,171,172,173,187,184,185,186,187,184,185,186,187,184,185,186,187,186,67,186,187,184,185,186,187,8,9
8,9,194,195,196,197,194,195,196,197,194,195,196,197,194,195,180,181,182,183,196,197,194,195,196,197,194,195,196,197,194,195,196,197,67,67,67,67,67,67,196,197,194,195,196,197,194,195,196,197,194,195,196,180,181,182,183,197,194,195,196,197,194,195,196,197,194,195,196,197,186,67,196,197,194,195,196,197,8,9
8,9,204,205,206,207,204,205,206,207,204,205,206,207,204,205,190,191,192,193,206,207,204,205,206,207,204,205,206,207,204,67,67,67,67,170,171,172,173,67,67,67,67,205,206,207,204,205,206,207,204,205,206,190,191,192,193,207,204,205,206,207,204,205,206,207,204,205,206,207,186,67,206,207,204,205,206,207,8,9
8,9,174,175,176,177,174,175,176,177,174,175,176,177,174,175,200,201,202,203,176,177,174,175,176,177,174,175,176,177,174,67,176,177,174,180,181,182,183,175,176,177,67,175,176,177,174,175,176,177,174,175,176,200,201,202,203,177,174,175,176,177,67,67,67,67,67,67,67,67,67,67,176,177,174,175,176,177,8,9
8,9,67,67,67,67,67,67,67,67,67,67,186,187,184,185,186,187,184,185,186,187,184,185,186,187,184,185,186,67,67,67,67,187,184,190,191,192,193,185,186,67,67,67,67,187,184,185,186,187,184,185,186,187,184,185,186,187,184,185,186,187,184,184,185,186,187,184,185,186,187,185,186,187,184,185,186,187,8,9
8,9,194,195,196,197,194,195,196,197,194,195,67,67,194,195,196,197,194,195,196,197,194,195,196,197,194,195,196,197,194,195,196,67,194,200,201,202,203,195,67,197,194,195,196,197,194,195,196,197,194,195,196,197,194,195,196,197,194,195,196,197,194,194,195,196,197,194,195,196,197,195,196,197,194,195,196,197,8,9
8,9,204,205,206,207,204,205,206,207,204,205,206,207,204,205,206,207,204,205,206,207,204,205,206,207,204,205,206,207,204,205,206,207,67,205,206,207,204,67,206,207,204,205,206,207,204,205,206,207,204,205,206,207,204,205,206,207,204,205,206,207,204,204,205,206,207,204,205,206,207,205,206,207,204,205,206,207,8,9
8,9,174,175,176,177,174,175,176,177,174,175,176,177,174,175,176,177,44,67,174,175,174,175,176,177,174,175,176,177,174,175,176,177,174,67,176,177,67,175,176,177,174,175,176,177,174,175,176,177,174,175,176,177,174,175,67,47,174,175,176,177,174,175,176,177,174,175,176,177,204,205,206,207,174,44,67,67,8,9
8,9,184,185,186,187,184,185,186,187,184,185,186,187,184,185,186,44,67,185,184,185,184,67,67,67,67,185,186,187,184,185,186,187,184,185,67,67,184,185,186,187,184,185,186,187,184,185,67,67,67,67,186,187,184,185,186,67,47,185,186,187,184,185,186,187,184,185,186,187,184,185,186,187,44,67,67,67,8,9
8,9,194,195,196,197,194,195,196,197,194,195,196,197,194,195,44,67,67,195,194,195,194,195,196,197,194,195,196,197,194,195,196,197,194,195,196,197,194,195,196,197,194,195,196,197,194,195,196,197,194,195,196,197,194,195,196,67,67,47,196,197,194,195,196,197,194,195,196,197,194,195,196,44,67,67,67,67,8,9
8,9,204,205,206,207,204,205,206,207,204,205,206,207,204,44,67,207,204,205,204,205,204,205,206,207,204,205,206,207,204,205,206,207,204,205,206,207,204,205,206,207,204,205,206,207,204,205,206,207,204,205,206,207,204,205,206,207,204,67,47,207,204,205,206,207,204,205,206,207,204,205,44,67,67,67,67,67,8,9
8,9,174,175,176,177,174,175,176,177,174,175,176,177,44,67,67,177,174,170,171,172,173,175,176,177,174,67,67,67,67,175,176,177,174,175,176,177,174,175,176,177,174,67,67,67,67,175,176,177,174,170,171,172,173,175,176,177,174,67,67,47,174,175,176,177,174,175,176,177,174,44,67,67,67,67,67,67,8,9
8,9,184,185,186,187,184,185,186,187,184,185,186,44,67,185,186,187,184,180,181,182,183,185,186,187,184,185,186,187,184,185,186,187,184,185,186,187,184,185,186,187,184,185,186,187,184,185,186,187,184,180,181,182,183,185,186,187,184,185,186,67,47,185,186,187,184,185,186,187,44,67,67,67,67,67,67,67,8,9
8,9,194,195,196,197,194,195,196,197,194,195,44,67,67,195,196,197,194,190,191,192,193,195,196,197,194,195,196,197,194,195,196,197,194,195,196,197,194,195,196,197,194,195,196,197,194,195,196,197,194,190,191,192,193,195,196,197,194,195,196,67,67,47,196,197,194,195,196,44,67,67,67,67,67,67,67,67,8,9
8,9,204,205,206,207,204,205,206,207,204,44,67,207,204,205,206,207,204,200,201,202,203,205,206,207,204,205,206,207,204,205,206,207,44,67,67,67,67,47,206,207,204,205,206,207,204,205,206,207,204,200,201,202,203,205,206,207,204,205,206,207,204,67,47,207,204,205,44,67,67,67,67,67,67,67,67,67,8,9
8,9,174,175,176,177,174,175,176,177,44,67,67,177,174,175,176,177,174,175,176,177,174,175,176,177,174,175,176,177,174,175,176,44,67,67,67,67,67,67,47,177,174,175,176,177,174,175,176,177,174,175,176,177,174,175,176,177,174,175,176,177,174,67,67,67,67,67,67,67,67,67,67,67,67,67,67,67,8,9
8,9,5,5,5,5,5,5,5,5,5,5,5,5,5,5,5,5,5,5,5,5,5,5,5,5,5,5,5,5,5,5,5,5,5,5,5,5,5,5,5,5,5,5,5,5,5,5,5,5,5,5,5,5,5,5,5,5,5,5,5,5,5,5,5,5,5,5,5,5,5,5,5,5,5,5,5,5,8,9
8,9,67,67,67,67,67,67,67,67,67,67,67,67,67,67,67,67,67,67,67,67,67,67,67,67,67,67,67,67,67,67,67,67,67,67,67,67,67,67,67,67,67,67,67,67,67,67,67,67,67,67,67,67,67,67,67,67,67,67,67,67,67,67,67,67,67,67,67,67,67,67,67,67,67,67,67,67,8,9
