21,62,62,62,62
21,22,18,18,18,18,18,18,18,18,18,18,98,98,18,98,18,18,18,18,98,98,98,18,98,98,62,18,61,18,18,18,18,61,145,18,61,18,61,61,18,18,62,18,18,143,62,18,18,61,18,18,18,18,18,18,18,18,18,18,61,18,61,61,18,18,18,18,18,143,61,18,18,18,18,61,61,18,21,22
21,22,44,45,46,47,44,45,46,47,44,98,46,98,62,45,46,47,44,45,98,98,44,45,46,98,98,62,61,44,44,45,46,47,145,45,46,44,61,46,61,44,45,46,143,61,45,62,143,61,45,61,47,44,45,46,47,44,45,46,61,62,62,62,62,62,62,62,62,46,143,45,46,47,44,45,46,61,21,22
21,22,54,143,143,143,54,55,56,57,54,98,56,62,98,98,56,57,54,98,98,98,62,62,62,62,62,62,62,61,61,55,61,57,54,61,61,61,61,61,61,62,61,61,61,61,55,61,61,61,143,61,57,61,55,61,57,61,55,56,62,62,61,57,62,62,57,54,55,62,54,143,56,57,54,61,56,57,21,22
21,135,62,135,135,62,62,62,135,67,98,98,62,98,98,98,98,66,98,98,98,62,62,98,98,67,98,143,62,62,98,61,61,67,145,166,61,166,61,166,62,166,166,143,166,61,61,166,62,61,143,61,61,61,166,61,61,64,62,61,143,61,61,61,65,61,61,62,61,62,62,143,143,67,64,61,66,67,21,61
21,22,62,62,62,62,135,135,135,98,98,98,62,98,98,98,53,98,98,98,62,143,98,98,98,98,98,98,98,62,62,98,143,61,143,143,143,143,61,53,61,74,61,61,77,74,75,44,62,46,61,143,143,74,75,166,166,62,166,61,61,51,52,53,61,61,47,44,62,61,62,61,143,143,61,61,61,77,21,22
21,22,143,135,135,135,135,135,98,98,98,62,98,98,98,98,98,98,98,62,143,143,54,98,98,98,98,145,98,62,98,62,83,83,61,61,61,143,143,143,62,61,143,44,45,46,47,61,55,62,61,54,55,143,143,62,143,143,143,61,61,61,62,61,61,145,61,61,46,145,62,45,61,61,143,45,61,47,21,22
21,22,143,135,135,135,135,135,98,135,62,98,98,98,98,98,98,98,98,62,98,98,126,98,62,62,62,62,62,98,62,98,83,62,83,61,61,145,61,61,61,61,143,61,55,61,61,61,61,66,62,61,45,61,61,126,126,126,61,61,126,61,126,126,145,145,145,61,145,62,62,55,56,61,61,55,56,57,21,22
21,143,55,55,135,135,135,98,98,135,62,98,98,98,98,143,61,166,62,98,61,98,98,62,62,98,98,98,62,62,62,98,83,83,62,61,61,61,145,62,145,145,61,143,61,66,62,74,62,76,62,62,61,62,62,61,62,62,61,62,145,62,62,62,126,67,64,65,61,145,62,65,66,67,143,61,66,61,21,22
143,143,55,166,98,98,135,98,135,83,62,61,61,143,83,83,56,56,62,98,98,98,98,62,98,98,98,98,98,62,62,98,83,61,83,62,83,126,61,5,61,145,61,62,61,62,5,126,126,61,62,62,62,145,145,145,145,61,61,61,6,166,61,61,6,62,62,62,145,61,62,62,76,77,143,61,61,6,21,22
98,98,98,98,98,98,98,98,83,62,61,61,143,61,145,83,145,145,62,98,98,98,62,62,62,62,98,62,62,98,62,98,98,61,61,83,62,61,83,126,62,62,61,126,126,126,143,61,61,145,145,62,145,61,61,61,145,145,61,61,61,145,61,145,145,126,145,145,62,62,61,45,62,47,143,61,46,47,21,61
21,98,98,98,98,98,98,98,98,62,98,61,57,61,66,83,145,83,98,98,145,62,62,62,83,61,98,98,98,98,62,98,83,98,61,83,62,62,62,83,145,61,54,145,61,57,143,145,145,145,56,62,55,56,61,55,145,61,54,61,145,61,61,61,56,145,126,145,145,62,62,62,61,145,61,61,61,57,21,22
21,98,5,98,98,98,98,98,62,62,61,98,98,98,98,98,62,62,62,62,62,62,62,62,62,98,98,98,98,83,62,98,98,98,66,64,62,62,61,126,61,61,126,126,126,61,145,143,64,61,62,67,62,66,67,65,145,61,145,145,66,67,61,145,61,145,126,145,145,145,145,65,62,62,61,145,145,67,21,22
21,98,55,166,98,98,64,98,62,98,61,166,61,62,62,62,62,62,62,62,62,98,62,98,62,98,98,98,83,83,62,61,98,98,61,62,83,62,77,75,76,145,61,145,145,61,126,143,126,62,126,126,126,126,61,61,126,61,145,61,145,145,61,166,61,126,145,61,6,62,145,61,61,62,61,75,61,77,21,22
98,98,98,98,98,126,126,145,62,98,44,62,62,98,98,62,62,98,98,62,62,62,62,62,62,62,98,98,98,83,62,61,98,98,62,83,83,62,44,45,61,61,61,61,47,61,61,166,62,145,145,145,62,145,145,61,145,61,61,145,61,47,61,145,145,61,61,61,62,47,145,144,145,145,62,62,145,145,21,145
98,98,98,98,55,61,126,126,62,83,62,98,98,98,62,62,98,98,62,62,98,98,98,98,98,62,62,98,98,98,62,83,98,98,62,61,62,62,61,61,61,166,61,166,166,166,166,62,61,55,56,57,61,62,61,145,61,61,61,61,126,61,61,145,126,126,145,61,62,145,145,145,144,143,143,55,61,145,21,145
166,22,55,98,55,166,5,126,62,62,98,98,98,62,62,98,98,98,98,62,62,145,83,98,98,98,62,98,98,98,62,98,98,62,62,62,62,62,64,65,166,67,61,61,67,61,62,66,61,143,61,67,65,62,145,145,166,61,145,61,126,61,52,126,126,145,61,145,61,145,145,166,166,143,62,65,62,61,61,145
166,22,55,98,166,61,61,61,62,98,61,61,98,62,83,83,98,98,98,62,62,62,98,83,83,47,62,62,98,62,62,62,62,62,62,98,98,145,61,166,61,61,75,61,77,62,75,61,61,143,126,61,126,76,126,126,61,61,126,61,61,61,126,126,145,77,145,62,56,61,143,143,143,143,145,76,62,145,61,22
166,22,55,98,61,61,61,61,62,61,54,65,62,98,98,66,98,61,145,98,62,62,62,55,62,57,62,62,62,62,61,98,98,62,62,61,98,98,145,166,61,61,143,143,62,56,57,54,61,143,143,77,55,62,61,61,61,61,61,61,61,71,126,126,55,56,61,65,66,67,61,61,145,166,166,62,62,62,61,61
166,22,61,55,98,98,98,166,62,61,64,98,62,61,83,98,98,83,83,98,62,62,62,62,62,62,62,62,62,62,98,98,98,62,83,61,98,61,61,61,61,143,7,61,62,66,61,126,61,61,61,61,61,62,61,61,61,61,61,61,61,61,61,61,61,56,62,145,61,77,61,61,61,61,61,62,61,62,145,61
61,22,61,5,5,145,98,98,62,98,98,62,98,98,98,66,98,98,62,62,62,98,98,98,61,62,98,62,98,98,98,62,62,62,83,62,98,66,61,61,145,62,61,62,145,61,126,62,5,61,143,62,143,145,145,61,62,61,61,166,61,61,61,61,5,62,5,145,5,61,61,145,145,61,64,62,145,62,145,22
21,61,61,61,61,145,61,166,62,166,61,62,61,61,145,62,62,62,91,61,61,62,61,61,66,143,61,61,62,61,61,62,45,166,62,61,61,143,61,62,62,145,61,61,61,61,61,61,166,61,166,61,143,145,62,45,61,61,61,61,62,61,62,61,61,61,61,61,61,61,61,61,61,61,61,62,61,62,61,61
61,166,56,61,145,40,41,61,62,91,62,61,62,62,62,166,145,66,91,54,61,62,61,61,45,61,47,54,62,62,62,61,55,56,62,166,143,62,62,166,91,61,54,55,56,126,66,61,61,61,61,61,66,61,62,61,61,61,66,55,61,61,61,62,61,62,61,62,61,61,61,145,62,62,62,61,61,62,61,22
61,61,61,61,61,61,61,166,62,62,62,61,62,62,62,62,61,62,61,62,61,62,62,61,62,61,62,62,62,62,62,61,65,62,62,62,62,91,61,61,66,61,66,61,61,61,61,143,61,61,61,65,66,61,61,61,61,61,61,61,126,61,62,61,61,61,145,61,61,62,62,61,61,145,54,145,145,62,21,22
143,61,61,61,61,166,61,61,166,62,62,62,62,62,166,61,65,61,91,62,62,62,62,62,62,62,62,61,62,145,145,61,61,145,143,61,62,145,145,61,66,91,61,166,61,61,143,61,61,61,61,61,61,61,62,145,61,61,61,61,61,61,61,145,61,61,145,61,45,66,61,61,145,61,61,145,61,62,61,21
143,61,66,61,61,61,166,62,62,62,62,61,62,62,62,62,61,62,62,61,61,61,62,62,126,61,66,66,62,66,61,5,5,5,143,166,41,62,61,145,145,61,145,61,61,56,61,61,166,61,61,61,143,143,145,54,55,61,61,61,62,61,145,145,145,61,145,54,66,66,5,54,145,145,145,61,145,62,61,22
61,61,143,61,61,166,61,61,166,166,145,61,61,62,61,61,61,61,61,66,66,61,61,62,61,61,91,61,62,91,61,61,91,61,143,61,61,61,53,61,143,143,143,61,61,61,145,126,61,126,61,61,61,145,62,61,61,61,126,62,145,145,166,145,166,66,67,64,66,66,61,64,145,61,145,145,145,62,21,22
61,166,145,61,61,61,61,61,5,61,61,62,62,62,61,61,61,61,61,61,61,61,61,62,65,126,166,66,62,61,5,61,5,61,143,143,61,143,62,62,143,61,66,61,66,61,66,61,145,61,61,61,126,61,126,62,61,62,61,61,61,166,61,145,46,61,44,61,66,47,66,143,145,47,145,145,62,47,21,22
61,61,61,61,61,61,143,61,143,61,61,61,5,62,62,46,47,61,45,46,47,126,126,61,62,61,91,91,62,145,61,61,91,5,166,91,61,72,73,61,61,62,62,91,91,91,66,66,66,61,143,61,45,145,62,145,61,61,61,55,61,71,61,145,56,61,54,66,56,57,66,145,145,145,145,145,62,57,21,22
166,61,61,61,45,166,47,44,61,61,166,61,61,61,62,62,57,61,61,56,57,126,126,61,62,61,55,56,62,54,61,61,145,166,166,61,66,65,61,66,54,54,66,54,62,56,62,62,61,62,62,61,62,145,57,66,61,61,66,65,61,67,61,145,66,67,66,66,66,66,66,145,66,145,145,145,145,67,21,22
21,61,61,61,61,166,166,54,61,61,166,61,61,61,61,62,62,62,62,62,143,126,65,61,62,143,65,62,62,64,65,61,145,145,145,61,145,61,61,66,54,61,65,64,65,66,61,143,56,166,66,61,61,145,62,56,61,145,145,66,61,61,44,61,145,61,61,5,5,5,145,61,46,145,145,61,62,47,61,22
21,22,61,64,61,66,166,64,65,61,67,166,61,61,126,61,62,62,126,145,62,61,62,62,62,61,62,62,65,61,45,61,61,66,61,61,145,61,61,145,145,145,65,44,45,143,166,166,166,5,5,61,61,145,61,61,61,61,5,145,145,61,54,61,145,145,5,55,56,145,145,145,145,145,54,62,56,57,21,22
21,22,145,61,61,61,166,44,45,46,61,61,61,61,61,61,61,46,62,62,62,62,62,62,62,62,145,145,145,61,61,61,166,61,166,61,54,61,166,61,166,145,145,145,143,145,145,145,61,76,77,61,61,66,62,61,61,77,5,66,145,61,145,61,61,145,145,65,145,145,145,145,145,145,62,145,75,76,21,22
21,22,145,65,61,56,61,54,55,56,57,61,166,166,5,61,61,145,145,61,126,61,61,61,61,61,143,143,61,145,65,61,61,61,61,54,54,61,54,61,54,54,143,143,166,166,67,61,61,61,61,61,145,145,62,76,145,61,61,5,145,61,145,61,145,145,145,145,145,75,76,77,145,47,62,145,46,47,21,22
21,22,145,65,65,61,166,61,65,66,67,54,61,61,166,166,166,61,61,126,126,145,145,61,61,61,61,61,61,143,61,61,61,61,166,166,66,166,61,61,61,61,61,61,61,61,61,74,75,76,166,166,166,61,66,145,61,145,145,145,145,61,61,61,61,145,145,145,145,145,54,55,145,62,145,145,56,57,21,22
21,22,145,44,45,46,61,166,61,61,47,44,5,61,166,166,166,166,61,50,51,52,53,44,61,61,61,166,61,46,61,143,61,61,166,56,66,54,143,61,57,5,5,44,45,46,47,61,61,166,166,50,51,61,62,66,61,61,145,61,61,61,61,65,66,67,145,166,66,145,145,62,62,67,145,145,66,67,21,61
21,22,55,145,56,56,57,61,61,56,57,61,5,61,61,166,166,166,166,61,166,166,166,61,166,61,61,61,166,166,61,61,143,61,61,61,143,61,61,61,166,166,166,166,166,166,166,166,55,54,55,60,61,62,62,145,61,61,145,61,61,66,5,144,61,47,44,145,74,62,62,145,61,61,61,61,61,5,61,22
61,22,65,145,56,56,67,166,61,61,61,61,61,166,67,61,65,66,67,70,61,166,166,61,166,61,166,61,61,66,66,61,66,61,143,61,61,61,54,61,66,61,65,65,61,66,61,61,61,64,61,61,61,72,145,145,61,61,66,61,61,61,61,61,61,61,62,62,61,61,61,145,145,145,145,145,5,5,21,22
21,61,66,145,145,56,65,66,55,55,61,61,61,61,61,55,166,166,166,166,55,61,61,61,61,61,61,166,61,56,55,61,56,61,55,6,61,62,61,61,62,61,61,61,62,61,61,62,61,61,61,62,74,61,62,62,61,62,61,145,62,61,62,145,62,145,166,65,66,145,145,65,66,67,64,145,5,5,21,22
21,61,5,5,145,5,61,166,166,61,5,61,166,61,5,61,5,61,5,5,5,5,5,5,61,5,61,61,61,5,5,61,62,61,62,5,5,61,5,5,61,5,5,5,61,166,166,61,166,61,61,61,61,61,62,5,5,61,5,5,5,5,61,5,61,166,166,5,5,5,145,145,5,5,5,5,5,5,21,22
21,61,7,7,145,7,7,7,166,7,166,7,61,7,7,61,61,61,61,7,61,7,7,7,7,61,61,61,61,61,62,62,7,7,61,7,7,7,7,7,7,7,7,61,7,7,7,61,61,61,7,145,145,61,62,166,166,61,166,166,166,61,61,166,61,7,7,7,7,7,7,145,145,145,7,7,7,7,21,22