21,22,18,18,18,18,18,18,18,18,18,18,18,18,18,18,18,18,18,18,18,18,18,18,18,18,18,18,18,18,18,18,18,18,18,18,18,18,18,18,18,18,18,18,18,18,18,18,18,18,18,18,18,18,18,18,18,18,18,18,18,18,18,18,18,18,18,18,18,18,18,18,18,18,18,18,18,18,21,22
21,22,44,45,46,47,44,45,46,47,44,45,46,47,44,45,46,47,44,45,46,47,44,45,46,47,44,45,46,44,44,45,46,47,44,45,46,44,45,46,47,44,45,46,47,44,45,46,47,44,45,46,47,44,45,46,47,44,45,46,44,45,46,47,45,46,47,44,45,46,44,45,46,47,44,45,46,47,21,22
21,22,54,55,56,57,54,55,56,57,54,55,56,57,54,55,56,57,54,55,56,57,54,55,56,57,54,55,56,54,54,55,56,57,54,55,56,54,55,56,57,54,55,56,57,54,55,56,57,54,55,56,57,54,55,56,57,54,55,56,54,55,56,57,55,56,57,54,55,56,54,55,56,57,54,55,56,57,21,22
21,22,64,65,66,67,64,65,66,67,64,65,66,40,41,42,43,67,64,65,66,67,64,65,66,67,64,65,66,64,64,65,66,67,64,65,40,41,42,43,67,64,65,66,67,64,65,66,67,64,65,66,67,64,65,66,67,64,65,66,40,41,42,43,65,66,67,64,65,66,64,65,66,67,64,65,66,67,21,22
21,22,74,75,76,77,74,75,76,77,74,75,76,50,51,52,53,77,74,75,76,77,74,75,76,77,74,75,76,74,74,75,76,77,74,75,50,51,52,53,77,74,75,76,77,74,75,44,45,46,47,76,77,74,75,76,77,74,75,76,50,51,52,53,45,46,47,44,45,46,74,75,76,77,74,75,76,77,21,22
21,22,55,55,55,55,54,55,56,57,54,55,56,60,61,62,63,57,54,55,56,57,54,55,56,57,54,55,56,57,54,55,56,57,65,64,60,61,62,63,65,66,67,44,45,46,47,54,55,56,57,54,55,56,44,45,46,47,44,45,60,61,62,63,46,47,44,45,46,47,44,45,46,47,44,45,46,47,21,22
21,22,55,55,55,55,64,65,66,67,64,54,55,70,71,72,73,56,57,57,66,67,64,65,66,67,64,65,66,67,64,65,66,67,66,54,70,71,72,73,45,46,47,54,55,56,57,64,65,66,67,44,45,46,47,55,56,57,54,55,70,71,72,73,56,57,54,55,56,57,54,55,56,57,54,55,56,57,21,22
21,22,55,55,55,55,44,45,46,47,5,5,5,5,5,5,5,5,5,5,5,5,44,45,46,47,44,45,46,47,44,45,46,47,66,64,65,66,67,54,55,56,57,64,65,66,67,74,75,76,77,47,55,56,57,65,66,67,64,65,66,67,64,65,66,67,64,65,66,67,64,65,66,67,64,65,66,67,21,22
21,22,55,55,55,55,54,55,56,5,54,55,56,57,54,55,56,56,54,55,56,57,5,5,56,57,54,55,56,5,5,5,5,5,5,5,5,5,5,5,5,5,5,5,5,5,5,54,54,55,56,57,65,5,6,6,6,6,6,6,6,6,6,6,6,6,6,6,6,77,74,75,76,77,6,6,6,6,21,22
21,22,55,55,55,55,64,65,5,44,45,46,47,46,47,44,45,46,47,45,46,47,45,46,47,44,45,46,47,5,44,45,46,47,66,44,45,46,47,45,46,47,44,45,46,47,5,5,44,45,46,47,5,5,77,45,46,47,44,45,46,47,44,45,46,47,44,45,6,47,44,45,46,47,44,45,46,47,21,22
21,22,55,55,55,55,44,45,46,54,55,56,57,56,57,54,55,56,57,55,56,57,55,56,57,54,55,56,57,47,54,55,56,57,56,54,55,56,57,55,56,57,54,55,56,57,67,44,54,55,56,57,55,56,57,55,56,57,54,55,56,57,54,55,56,57,54,55,6,57,54,55,56,57,54,55,56,57,21,22
21,22,5,55,56,55,54,55,56,64,65,66,67,66,67,64,65,66,67,65,66,67,65,66,67,64,65,66,67,57,64,65,66,67,66,64,65,66,67,65,66,67,64,65,66,67,47,54,64,65,66,67,65,66,67,65,66,67,64,65,66,67,64,65,66,67,64,65,6,67,64,65,66,67,64,65,66,67,21,22
21,22,55,5,55,55,64,65,66,74,75,76,77,76,77,74,75,76,77,75,76,77,75,76,77,74,75,76,77,67,74,75,76,77,66,74,75,76,77,75,76,77,74,75,76,77,57,64,74,75,76,77,75,76,77,75,76,77,74,75,76,77,74,75,76,77,74,75,6,77,74,75,76,77,74,75,76,77,21,22
21,22,55,55,5,55,44,45,46,47,44,5,46,47,44,45,5,5,5,45,46,47,5,5,46,47,44,45,46,47,64,65,66,56,56,66,65,66,44,45,46,47,45,46,47,44,45,46,47,45,46,47,45,46,47,45,46,47,44,45,46,47,44,45,46,47,44,45,6,47,44,45,46,47,44,45,46,47,21,22
21,22,55,55,55,5,54,55,56,57,54,5,56,57,54,55,56,5,54,55,56,57,54,5,5,57,54,55,56,57,64,65,66,67,56,56,5,5,54,55,56,57,55,56,57,54,55,56,57,55,56,57,55,56,57,55,56,57,54,55,40,41,42,43,56,57,54,55,6,57,54,55,56,57,54,55,56,57,21,22
21,22,55,55,55,55,5,65,66,67,64,5,66,67,64,65,66,5,64,65,66,67,64,65,5,5,64,65,66,67,54,55,56,57,56,66,5,5,64,65,66,67,65,66,67,64,65,66,67,65,66,67,65,66,67,65,66,67,64,65,50,51,52,53,66,67,44,45,46,47,64,65,66,67,64,65,66,67,21,22
21,22,55,55,55,55,44,45,46,47,44,65,46,47,44,45,46,5,44,45,46,47,44,45,46,47,44,45,46,47,64,65,66,67,56,66,56,56,74,75,76,77,75,76,77,74,75,76,77,75,76,77,75,76,77,75,76,77,74,75,60,61,62,63,76,77,54,55,56,57,74,75,76,74,75,76,77,77,21,22
21,22,55,55,55,55,54,55,56,57,54,65,56,57,54,55,56,5,54,55,56,57,54,55,56,57,54,55,56,57,54,55,56,57,56,56,5,5,56,64,66,66,67,54,55,56,57,54,74,75,76,77,55,56,57,54,55,56,57,54,70,71,72,73,55,56,64,65,66,67,57,54,55,74,75,76,77,47,21,22
21,22,55,55,55,55,64,65,66,67,64,65,66,67,64,65,66,5,64,65,66,67,64,65,66,67,64,65,66,67,64,65,66,67,66,56,5,5,56,56,56,7,7,64,65,66,67,64,56,56,56,56,56,56,56,56,56,56,56,56,56,56,56,56,56,56,74,75,76,77,56,56,56,46,54,55,56,57,21,22
21,22,5,5,5,5,5,5,5,5,5,5,66,66,66,66,66,5,5,5,5,5,5,5,5,5,5,5,5,5,67,67,67,67,67,56,56,66,66,56,56,67,67,67,67,5,5,5,5,5,5,5,5,5,5,5,5,5,5,5,5,5,5,5,5,5,5,5,5,5,5,5,46,46,64,65,66,67,21,22
21,22,66,44,45,46,47,44,45,46,47,44,45,46,47,66,56,66,74,44,45,46,47,56,66,66,66,44,45,46,47,44,45,46,47,56,5,5,66,56,56,56,44,45,46,47,44,45,46,47,44,45,46,47,44,45,46,47,44,45,46,47,44,45,46,47,44,45,46,47,44,5,46,47,74,75,76,77,21,22
21,22,56,54,55,40,41,42,43,56,57,54,55,56,57,44,45,46,47,54,55,56,57,44,45,46,47,54,55,56,57,54,55,56,57,56,5,5,56,66,66,56,54,55,56,57,54,55,56,57,54,55,56,57,54,55,56,57,54,55,56,57,54,55,56,57,54,55,56,57,54,5,56,74,75,76,77,47,21,22
21,22,56,56,65,50,51,52,53,66,67,64,65,66,67,54,55,56,57,64,65,66,67,54,55,56,57,64,65,66,67,64,65,66,67,56,56,56,56,56,66,66,64,65,66,67,64,65,66,67,64,65,66,67,64,65,66,67,64,65,66,67,64,65,66,67,64,65,66,67,5,5,66,67,54,55,56,57,21,22
21,22,65,44,45,60,61,62,63,46,47,44,45,46,47,64,65,66,67,44,45,46,47,64,65,66,67,44,45,46,47,54,56,54,5,5,5,5,5,5,66,66,56,44,45,46,47,44,45,46,47,44,45,46,47,44,45,46,47,44,45,46,47,44,45,46,47,44,45,46,5,44,45,46,64,65,66,67,21,21
21,22,66,54,55,70,71,72,73,56,57,54,55,56,57,44,45,46,47,54,55,56,57,44,45,46,47,54,55,56,57,5,5,5,5,40,41,42,43,5,5,5,5,54,55,56,57,54,55,56,57,54,55,56,57,54,55,56,57,54,40,41,42,43,55,56,57,54,55,56,5,54,55,56,74,75,76,77,21,22
21,22,74,64,65,66,67,64,65,66,67,64,65,66,67,54,55,56,57,64,65,66,67,54,55,56,57,64,65,66,67,5,54,66,65,50,51,52,53,65,54,54,5,64,65,66,67,64,65,66,67,64,65,66,67,64,65,66,67,64,50,51,52,53,65,66,67,64,65,66,66,64,65,66,67,55,55,55,21,22
21,22,5,5,5,5,5,5,5,5,5,5,65,65,56,64,65,66,67,5,5,5,5,64,65,66,67,66,66,5,5,5,5,54,66,60,61,62,63,65,54,5,5,5,5,56,56,44,45,46,47,5,5,5,5,56,66,66,44,45,60,61,62,63,46,47,44,45,46,47,66,75,46,47,75,75,46,47,21,22
21,22,74,74,56,74,74,74,74,56,65,74,5,44,45,46,47,44,45,46,47,44,45,46,47,44,45,46,47,44,45,46,47,5,54,70,71,72,73,54,5,66,66,44,45,46,47,54,55,56,57,44,45,46,47,56,66,56,54,55,70,71,72,73,56,57,54,55,56,57,66,55,56,57,54,55,56,57,21,22
21,22,65,44,45,46,47,44,45,46,47,56,56,54,55,56,57,54,55,56,57,54,55,56,57,54,55,56,57,54,55,56,57,65,5,54,66,65,65,5,54,54,66,54,55,56,57,64,65,66,67,54,55,56,57,66,56,66,66,65,66,67,64,65,66,67,64,65,66,66,66,65,66,67,64,65,66,67,21,22
21,22,66,54,55,56,57,54,55,56,57,66,74,64,65,66,67,64,65,66,67,64,65,66,67,64,65,66,65,64,65,66,67,56,54,5,65,66,5,66,54,66,65,64,65,66,56,56,56,56,56,64,65,66,66,56,66,56,56,66,66,56,44,45,46,47,5,5,5,5,5,75,46,75,75,75,46,47,21,22
21,22,65,64,65,66,74,64,65,66,67,44,45,46,47,5,5,5,5,44,45,46,47,5,5,5,5,56,65,44,45,46,47,66,54,65,5,5,65,66,54,54,65,44,45,46,47,5,5,5,5,44,45,46,47,5,5,5,5,66,56,66,54,55,56,57,5,55,56,57,5,75,56,57,54,55,56,57,21,22
21,22,65,74,74,74,74,44,45,46,47,54,55,56,57,5,45,46,47,54,55,56,57,44,45,46,47,65,65,54,55,56,57,66,56,65,54,66,65,54,54,66,66,54,55,56,57,74,75,76,77,54,55,74,75,76,77,77,5,66,66,66,55,55,56,5,5,65,66,67,5,5,74,75,76,74,75,76,21,22
21,22,65,65,74,56,66,54,55,56,57,64,65,66,5,5,55,56,57,64,65,66,67,54,55,56,57,54,56,64,65,66,67,54,56,54,54,54,54,54,54,54,66,64,65,66,67,54,55,56,57,64,65,74,75,76,77,56,5,5,56,66,74,75,76,77,44,45,74,75,76,77,46,47,44,45,46,47,21,22
21,22,55,65,65,65,65,64,65,66,67,54,55,5,5,55,56,66,67,40,41,42,43,64,65,66,67,5,5,5,5,54,65,44,45,46,47,44,45,46,47,66,65,5,5,5,5,74,75,76,77,40,41,42,43,74,75,76,77,5,5,74,75,76,77,57,54,55,56,57,54,55,56,57,54,55,56,57,21,22
21,22,65,44,45,46,47,44,45,46,47,44,5,5,47,44,45,46,47,50,51,52,53,44,45,46,47,44,45,46,47,5,5,54,55,56,57,54,55,56,57,5,5,44,45,46,47,44,45,44,45,50,51,52,53,44,45,44,45,46,5,5,64,65,66,67,64,65,66,67,64,65,66,67,64,65,66,67,21,22
21,22,55,54,56,56,57,54,55,56,57,5,5,56,57,54,55,56,57,60,61,62,63,54,55,56,57,54,55,56,57,55,55,64,65,66,67,64,65,66,67,65,56,54,55,56,57,54,55,54,55,60,61,62,63,54,55,54,55,56,57,5,5,45,46,47,44,45,74,75,76,77,46,47,44,45,46,5,21,22
21,22,65,65,56,56,67,64,65,66,5,5,65,66,67,64,65,66,67,70,71,72,73,64,65,66,67,64,65,66,67,55,55,55,55,54,5,5,54,54,66,56,65,65,65,66,67,64,65,64,65,70,71,72,73,64,65,64,65,66,67,56,5,5,56,57,54,55,56,57,54,55,56,57,54,55,5,5,21,22
21,22,66,65,65,56,65,66,55,55,5,65,55,55,55,55,55,55,55,55,55,55,55,55,55,55,55,65,65,56,55,55,56,55,55,6,6,6,6,54,54,54,66,65,65,66,56,56,56,74,75,76,74,75,76,74,75,74,75,76,77,66,64,5,66,67,64,65,66,67,64,65,66,67,64,5,5,5,21,22
21,22,5,5,5,5,5,5,5,5,5,5,5,5,5,5,5,5,5,5,5,5,5,5,5,5,5,5,5,5,5,5,5,5,5,5,5,5,5,5,5,5,5,5,5,5,5,5,5,5,5,5,5,5,5,5,5,5,5,5,5,5,5,5,5,5,5,5,5,5,5,5,5,5,5,5,5,5,21,22
21,22,7,7,7,7,7,7,7,7,7,7,7,7,7,7,7,7,7,7,7,7,7,7,7,7,7,7,7,7,7,7,7,7,7,7,7,7,7,7,7,7,7,7,7,7,7,7,7,7,7,7,7,7,7,7,7,7,7,7,7,7,7,7,7,7,7,7,7,7,7,7,7,7,7,7,7,7,21,22
