120,121,122,123,124,125,126,127,128,129,130,131,132,133,134,120,121,122,123,124,125,126,127,128,129,130,131,132,133,134,120,121,122,123,124,125,126,127,128,129,130,131,132,133,134,120,121,122,123,124,125,126,127,128,129,130,131,132,133,134,120,121,122,123,124,125,126,127,128,129,130,131,132,133,134,120,121,122,123,124
140,141,142,143,144,145,146,147,148,149,150,151,152,153,154,140,141,142,143,144,145,146,147,148,149,150,151,152,153,154,140,141,142,143,144,145,146,147,148,149,150,151,152,153,154,140,141,142,143,144,145,146,147,148,149,150,151,152,153,154,140,141,142,143,144,145,146,147,148,149,150,151,152,153,154,140,141,142,143,144
160,161,162,163,164,165,166,167,168,169,170,171,172,173,174,160,161,162,163,164,165,166,167,168,169,170,171,172,173,174,160,161,162,163,164,165,166,167,168,169,170,171,172,173,174,160,161,162,163,164,165,166,167,168,169,170,171,172,173,174,160,161,162,163,164,165,166,167,168,169,170,171,172,173,174,160,161,162,163,164
180,181,182,183,184,185,186,187,188,189,190,191,192,193,194,180,181,182,183,184,185,186,187,188,189,190,191,192,193,194,180,181,182,183,184,185,186,187,188,189,190,191,192,193,194,180,181,182,183,184,185,186,187,188,189,190,191,192,193,194,180,181,182,183,184,185,186,187,188,189,190,191,192,193,194,180,181,182,183,184
200,201,202,203,204,205,206,207,208,209,210,211,212,213,214,200,201,202,203,204,205,206,207,208,209,210,211,212,213,214,200,201,202,203,204,205,206,207,208,209,210,211,212,213,214,200,201,202,203,204,205,206,207,208,209,210,211,212,213,214,200,201,202,203,204,205,206,207,208,209,210,211,212,213,214,200,201,202,203,204
220,221,222,223,224,225,226,227,228,229,230,231,232,233,234,220,221,222,223,224,225,226,227,228,229,230,231,232,233,234,220,221,222,223,224,225,226,227,228,229,230,231,232,233,234,220,221,222,223,224,225,226,227,228,229,230,231,232,233,234,220,221,222,223,224,225,226,227,228,229,230,231,232,233,234,220,221,222,223,224
240,241,242,243,244,245,246,247,248,249,250,251,252,253,254,240,241,242,243,244,245,246,247,248,249,250,251,252,253,254,240,241,242,243,244,245,246,247,248,249,250,251,252,253,254,240,241,242,243,244,245,246,247,248,249,250,251,252,253,254,240,241,242,243,244,245,246,247,248,249,250,251,252,253,254,240,241,242,243,244
236,237,256,257,256,257,256,257,256,257,256,257,256,257,256,257,256,257,256,257,256,257,256,257,256,257,256,257,256,257,256,257,256,257,256,257,256,257,256,257,256,257,256,257,256,257,256,257,256,257,256,257,256,257,256,257,256,257,256,257,256,257,256,257,256,257,256,257,256,257,256,257,256,257,256,257,256,257,236,237
256,257,116,117,118,119,116,117,118,119,116,117,118,119,116,117,118,119,116,117,118,119,116,117,118,119,116,117,118,119,116,117,118,119,116,117,118,119,116,117,118,119,116,117,118,119,116,117,118,119,116,117,118,119,116,117,118,119,116,117,118,119,116,117,118,119,116,117,118,119,116,117,118,119,116,117,118,119,256,257
276,277,136,137,138,139,136,137,138,139,136,137,138,139,136,137,138,139,136,137,138,139,136,137,138,139,136,137,138,139,136,137,138,139,136,137,138,139,136,137,138,139,136,137,138,139,136,137,138,139,136,137,138,139,136,137,138,139,136,137,138,139,136,137,138,139,136,137,138,139,136,137,138,139,136,137,138,139,276,277
236,237,156,157,158,159,156,157,158,159,156,157,158,159,156,157,158,159,156,157,158,159,156,157,158,159,156,157,158,159,156,157,158,159,156,157,158,159,156,157,158,159,156,157,158,159,156,157,158,159,156,157,158,159,156,157,158,159,156,157,158,159,156,157,158,159,156,157,158,159,156,157,158,159,156,157,158,159,236,237
256,257,176,177,178,179,176,177,178,179,176,177,178,179,176,177,178,179,176,177,178,179,176,177,178,179,176,177,178,179,176,177,178,179,176,177,178,179,176,177,178,179,176,177,178,179,176,177,178,179,176,177,178,179,176,177,178,179,176,177,178,179,176,177,178,179,176,177,178,179,176,177,178,179,176,177,178,179,256,257
276,277,196,197,198,199,196,197,198,199,196,197,198,199,196,197,198,199,196,197,198,199,196,197,198,199,196,197,198,199,196,197,198,199,196,197,198,199,196,197,198,199,196,197,198,199,196,197,198,199,196,197,198,199,196,197,198,199,196,197,198,199,196,197,198,199,196,197,198,199,196,197,198,199,196,197,198,199,276,277
236,237,116,117,118,119,116,117,118,119,116,117,118,119,116,117,118,119,116,117,118,119,116,117,118,119,116,117,118,119,116,117,118,119,116,117,118,119,116,117,118,119,116,117,118,119,116,117,118,119,116,117,118,119,116,117,118,119,116,117,118,119,116,117,118,119,116,117,118,119,116,117,118,119,116,117,118,119,236,237
256,257,136,137,138,139,136,137,138,139,136,137,138,139,136,137,138,139,136,137,138,139,136,137,138,139,136,137,138,139,136,137,138,139,136,137,138,139,136,137,138,139,136,137,138,139,136,137,138,139,136,137,138,139,136,137,138,139,136,137,138,139,136,137,138,139,136,137,138,139,136,137,138,139,136,137,138,139,256,257
276,277,156,157,158,159,156,157,158,159,156,157,158,159,156,157,158,159,156,157,158,159,156,157,158,159,156,157,158,159,156,157,158,159,156,157,158,159,156,157,158,159,156,157,158,159,156,157,158,159,156,157,158,159,156,157,158,159,156,157,158,159,156,157,158,159,156,157,158,159,156,157,158,159,156,157,158,159,276,277
236,237,176,177,178,179,176,177,178,179,176,177,178,179,176,177,178,179,176,177,178,179,176,177,178,179,176,177,178,179,176,177,178,179,176,177,178,179,176,177,178,179,176,177,178,179,176,177,178,179,176,177,178,179,176,177,178,179,176,177,178,179,176,177,178,179,176,177,178,179,176,177,178,179,176,177,178,179,236,237
256,257,196,197,198,199,196,197,198,199,196,197,198,199,196,197,198,199,196,197,198,199,196,197,198,199,196,197,198,199,196,197,198,199,196,197,198,199,196,197,198,199,196,197,198,199,196,197,198,199,196,197,198,199,196,197,198,199,196,197,198,199,196,197,198,199,196,197,198,199,196,197,198,199,196,197,198,199,256,257
276,277,116,117,118,119,116,117,118,119,116,117,118,119,116,117,118,119,116,117,118,119,116,117,118,119,116,117,118,119,116,117,118,119,116,117,118,119,116,117,118,119,116,117,118,119,116,117,118,119,116,117,118,119,116,117,118,119,116,117,118,119,116,117,118,119,116,117,118,119,116,117,118,119,116,117,118,119,276,277
236,237,136,137,138,139,136,137,138,139,136,137,138,139,136,137,138,139,136,137,138,139,136,137,138,139,136,137,138,139,136,137,138,139,136,137,138,139,136,137,138,139,136,137,138,139,136,137,138,139,136,137,138,139,136,137,138,139,136,137,138,139,136,137,138,139,136,137,138,139,136,137,138,139,136,137,138,139,236,237
256,257,156,157,158,159,156,157,158,159,156,157,158,159,156,157,158,159,156,157,158,159,156,157,158,159,156,157,158,159,156,157,158,159,156,157,158,159,156,157,158,159,156,157,158,159,156,157,158,159,156,157,158,159,156,157,158,159,156,157,158,159,156,157,158,159,156,157,158,159,156,157,158,159,156,157,158,159,256,257
276,277,65,66,65,66,65,66,65,66,65,66,65,66,65,66,65,66,65,66,65,66,65,66,65,66,65,66,65,66,65,66,65,66,65,66,65,66,65,66,65,66,65,66,65,66,65,66,65,66,65,66,65,66,65,66,65,66,65,66,65,66,65,66,65,66,65,66,65,66,65,66,65,66,176,177,178,179,276,277
236,237,85,86,85,86,85,86,85,86,85,86,85,86,85,86,85,86,85,86,85,86,85,86,85,86,85,86,85,86,85,86,85,86,85,86,85,86,85,86,85,86,85,86,85,86,85,86,85,86,85,86,85,86,85,86,85,86,85,86,85,86,85,86,85,86,85,86,85,86,85,86,85,86,196,197,198,199,236,237
256,257,116,117,118,119,116,117,118,119,116,117,118,119,116,117,118,119,116,117,118,119,116,117,118,119,116,117,118,119,116,117,118,119,116,117,118,119,116,117,118,119,116,117,118,119,116,117,118,119,116,117,118,119,116,117,118,119,116,117,118,119,116,117,118,119,116,117,118,119,116,117,118,119,116,117,118,119,256,257
276,277,136,137,138,139,136,137,138,139,136,137,138,139,136,137,138,139,136,137,138,139,136,137,138,139,136,137,138,139,136,137,138,139,136,137,138,139,136,137,138,139,136,137,138,139,136,137,138,139,136,137,138,139,136,137,138,139,136,137,138,139,136,137,138,139,136,137,138,139,136,137,138,139,136,137,138,139,276,277
236,237,156,157,158,159,156,157,158,159,156,157,158,159,156,157,158,159,156,157,158,159,156,157,158,159,156,157,158,159,156,157,158,159,156,157,158,159,156,157,158,159,156,157,158,159,156,157,158,159,156,157,158,159,156,157,158,159,156,157,158,159,156,157,158,159,156,157,158,159,156,157,158,159,156,157,158,159,236,237
256,257,176,177,178,179,176,177,178,179,176,177,178,179,176,177,178,179,176,177,256,257,256,257,178,179,176,177,178,179,176,177,178,179,176,177,178,179,176,177,178,179,176,177,178,179,176,177,178,179,176,177,178,179,176,177,178,179,176,177,178,179,176,177,178,179,176,177,178,179,176,177,178,179,176,177,178,179,256,257
276,277,196,197,198,199,196,197,198,199,196,197,198,199,196,197,198,199,196,197,198,199,196,197,198,199,196,197,198,199,196,197,198,199,196,197,198,199,196,197,198,199,196,197,198,199,196,197,198,199,196,197,198,199,196,197,198,199,196,197,198,199,196,197,198,199,196,197,198,199,196,197,198,199,196,197,198,199,276,277
236,237,116,117,118,119,116,117,118,119,116,117,118,119,116,117,118,119,116,117,118,119,116,117,118,119,116,117,118,119,116,117,118,119,116,117,118,119,116,117,118,119,116,117,118,119,116,117,118,119,116,117,118,119,116,117,118,119,116,117,118,119,116,117,118,119,116,117,118,119,116,117,118,119,116,117,118,119,236,237
256,257,136,137,138,139,136,137,138,139,136,137,138,139,136,256,257,256,257,137,138,139,136,137,138,256,257,256,257,139,136,137,138,139,136,137,138,139,136,137,138,139,136,137,138,139,136,137,138,139,136,137,138,139,136,137,138,139,136,137,138,139,136,137,138,139,136,137,138,139,136,137,138,139,136,137,138,139,256,257
276,277,156,157,158,159,156,157,158,159,156,157,158,159,156,157,158,159,156,157,158,159,156,157,158,159,156,157,158,159,156,157,158,159,156,157,158,159,156,157,158,159,156,157,158,159,156,157,158,159,156,157,158,159,156,157,158,159,156,157,158,159,156,157,158,159,156,157,158,159,156,157,158,159,156,157,158,159,276,277
236,237,176,177,178,179,176,177,178,179,176,177,178,179,176,177,178,179,137,138,137,138,176,177,178,179,176,177,178,179,176,177,178,179,176,177,178,179,176,177,178,179,176,177,178,179,176,177,178,179,176,177,178,179,176,177,178,179,176,177,178,179,176,177,178,179,176,177,178,179,176,177,178,179,176,177,178,179,236,237
256,257,196,197,198,199,196,197,198,199,196,197,198,199,196,197,198,199,196,197,198,199,196,197,198,199,196,197,198,199,196,197,198,199,196,197,198,199,196,197,198,199,196,197,198,199,196,197,198,199,196,197,198,199,196,197,198,199,196,197,198,199,196,197,198,199,196,197,198,199,196,197,198,199,196,197,198,199,256,257
276,277,116,117,118,119,116,117,118,119,116,256,257,256,257,138,118,119,116,117,118,119,116,117,137,138,116,117,118,119,256,257,256,257,116,117,118,119,116,117,118,119,116,117,118,119,116,117,118,119,116,117,118,119,116,117,118,119,116,117,118,119,116,117,118,119,116,117,118,119,116,117,118,119,116,117,118,119,276,277
236,237,136,137,138,139,136,137,138,139,136,137,138,139,136,137,138,139,136,137,138,139,136,137,138,139,136,137,138,139,136,137,138,139,136,137,138,139,136,137,138,139,136,137,138,139,136,137,138,139,136,137,138,139,136,137,138,139,136,137,138,139,136,137,138,139,136,137,138,139,136,137,138,139,136,137,138,139,236,237
256,257,156,157,158,159,156,157,158,159,137,138,158,159,156,157,158,159,156,157,158,159,156,157,158,159,137,138,137,159,156,157,158,159,156,157,158,159,156,157,158,159,156,157,158,159,156,157,158,159,156,157,158,159,156,157,158,159,156,157,158,159,156,157,158,159,156,157,158,159,156,157,158,159,156,157,158,159,256,257
276,277,176,177,178,179,176,177,178,179,176,177,178,179,176,177,178,179,176,177,178,179,176,177,178,179,176,177,178,179,176,177,178,179,176,177,178,179,176,177,178,179,176,177,178,179,176,177,178,179,176,177,178,179,176,177,178,179,176,177,178,179,176,177,178,179,176,177,178,179,176,177,178,179,176,177,178,179,276,277
236,237,196,197,198,199,196,197,198,199,196,197,198,199,196,197,198,199,196,197,198,199,196,197,198,199,196,197,198,199,196,197,198,199,196,197,198,199,196,197,198,199,196,197,198,199,196,197,198,199,196,197,198,199,196,197,198,199,196,197,198,199,196,197,198,199,196,197,198,199,196,197,198,199,196,197,198,199,236,237
256,257,65,66,65,66,65,66,65,66,65,66,65,66,65,66,65,66,65,66,65,66,65,66,65,66,65,66,65,66,65,66,65,66,65,66,65,66,65,66,65,66,65,66,65,66,65,66,65,66,65,66,65,66,65,66,65,66,65,66,65,66,65,66,65,66,65,66,65,66,65,66,65,66,65,66,65,66,256,257
276,277,85,86,85,86,85,86,85,86,85,86,85,86,85,86,85,86,85,86,85,86,85,86,85,86,85,86,85,86,85,86,85,86,85,86,85,86,85,86,85,86,85,86,85,86,85,86,85,86,85,86,85,86,85,86,85,86,85,86,85,86,85,86,85,86,85,86,85,86,85,86,85,86,85,86,85,86,276,277
